id,OCCUPANCY_DATE,ORGANIZATION_ID,ORGANIZATION_NAME,SHELTER_ID,SHELTER_GROUP,CAPACITY_ACTUAL_BED,OCCUPIED_BEDS,UNOCCUPIED_BEDS,OCCUPANCY_RATE_BEDS
1,2023-06-28,1014,Organization 26,2011,Shelter Group 4,175,68,107,0.38857142857142857
2,2023-01-14,1030,Organization 95,2089,Shelter Group 11,174,124,50,0.7126436781609196
3,2023-07-14,1062,Organization 76,2044,Shelter Group 20,90,81,9,0.9
4,2023-11-02,1040,Organization 93,2077,Shelter Group 24,105,138,-33,1.3142857142857143
5,2023-04-28,1095,Organization 43,2082,Shelter Group 23,152,194,-42,1.2763157894736843
6,2023-10-26,1039,Organization 24,2072,Shelter Group 4,74,69,5,0.9324324324324325
7,2023-08-17,1072,Organization 72,2051,Shelter Group 49,67,42,25,0.6268656716417911
8,2023-09-01,1014,Organization 65,2080,Shelter Group 4,56,158,-102,2.8214285714285716
9,2023-01-14,1048,Organization 87,2079,Shelter Group 20,100,17,83,0.17
10,2023-06-02,1065,Organization 35,2095,Shelter Group 35,65,49,16,0.7538461538461538
11,2023-03-31,1023,Organization 62,2021,Shelter Group 1,51,167,-116,3.2745098039215685
12,2023-04-01,1026,Organization 74,2095,Shelter Group 15,94,97,-3,1.0319148936170213
13,2023-09-13,1046,Organization 28,2052,Shelter Group 16,118,156,-38,1.3220338983050848
14,2023-07-16,1023,Organization 52,2037,Shelter Group 34,120,99,21,0.825
15,2023-04-01,1095,Organization 23,2071,Shelter Group 18,140,138,2,0.9857142857142858
16,2023-12-14,1063,Organization 15,2031,Shelter Group 11,97,134,-37,1.3814432989690721
17,2023-05-17,1021,Organization 39,2031,Shelter Group 33,138,17,121,0.12318840579710146
18,2023-12-21,1081,Organization 93,2050,Shelter Group 13,91,162,-71,1.7802197802197801
19,2023-11-24,1039,Organization 55,2050,Shelter Group 1,127,57,70,0.44881889763779526
20,2023-01-26,1071,Organization 86,2016,Shelter Group 35,50,23,27,0.46
21,2023-01-07,1045,Organization 16,2011,Shelter Group 20,121,81,40,0.6694214876033058
22,2023-05-17,1047,Organization 95,2009,Shelter Group 12,151,107,44,0.7086092715231788
23,2023-09-11,1076,Organization 76,2061,Shelter Group 16,154,84,70,0.5454545454545454
24,2023-07-30,1096,Organization 20,2073,Shelter Group 33,57,50,7,0.8771929824561403
25,2023-03-19,1046,Organization 73,2001,Shelter Group 23,113,63,50,0.5575221238938053
26,2023-03-22,1083,Organization 28,2025,Shelter Group 2,132,106,26,0.803030303030303
27,2023-02-12,1060,Organization 3,2050,Shelter Group 4,159,88,71,0.5534591194968553
28,2023-12-25,1083,Organization 45,2027,Shelter Group 5,155,30,125,0.1935483870967742
29,2023-11-28,1089,Organization 61,2064,Shelter Group 19,125,198,-73,1.584
30,2023-05-23,1017,Organization 57,2061,Shelter Group 35,86,105,-19,1.2209302325581395
31,2023-02-01,1009,Organization 60,2028,Shelter Group 34,191,46,145,0.24083769633507854
32,2023-04-19,1023,Organization 68,2038,Shelter Group 40,125,115,10,0.92
33,2023-09-20,1031,Organization 74,2034,Shelter Group 20,81,129,-48,1.5925925925925926
34,2023-11-26,1038,Organization 74,2028,Shelter Group 26,150,125,25,0.8333333333333334
35,2023-01-23,1033,Organization 5,2075,Shelter Group 42,155,129,26,0.832258064516129
36,2023-11-05,1080,Organization 75,2005,Shelter Group 5,104,177,-73,1.7019230769230769
37,2023-05-15,1060,Organization 12,2057,Shelter Group 37,165,197,-32,1.1939393939393939
38,2023-11-05,1072,Organization 5,2088,Shelter Group 22,92,137,-45,1.4891304347826086
39,2023-08-12,1005,Organization 88,2003,Shelter Group 4,79,37,42,0.46835443037974683
40,2023-06-15,1063,Organization 62,2005,Shelter Group 32,96,168,-72,1.75
41,2023-08-05,1074,Organization 68,2029,Shelter Group 15,85,82,3,0.9647058823529412
42,2023-10-17,1041,Organization 98,2072,Shelter Group 3,145,92,53,0.6344827586206897
43,2023-03-10,1092,Organization 96,2003,Shelter Group 47,98,132,-34,1.346938775510204
44,2023-03-13,1037,Organization 65,2046,Shelter Group 39,136,184,-48,1.3529411764705883
45,2023-03-17,1046,Organization 83,2062,Shelter Group 15,104,167,-63,1.6057692307692308
46,2023-03-04,1083,Organization 11,2014,Shelter Group 25,102,77,25,0.7549019607843137
47,2023-05-21,1097,Organization 39,2079,Shelter Group 24,70,73,-3,1.042857142857143
48,2023-07-29,1016,Organization 29,2079,Shelter Group 34,197,98,99,0.49746192893401014
49,2023-12-19,1006,Organization 91,2067,Shelter Group 43,69,64,5,0.927536231884058
50,2023-12-13,1052,Organization 88,2082,Shelter Group 40,87,144,-57,1.6551724137931034
51,2023-06-02,1072,Organization 5,2077,Shelter Group 34,99,14,85,0.1414141414141414
52,2023-10-21,1089,Organization 66,2002,Shelter Group 50,157,75,82,0.47770700636942676
53,2023-10-04,1078,Organization 41,2046,Shelter Group 22,175,130,45,0.7428571428571429
54,2023-02-10,1095,Organization 26,2058,Shelter Group 19,187,102,85,0.5454545454545454
55,2023-03-31,1046,Organization 28,2070,Shelter Group 46,87,174,-87,2
56,2023-11-12,1089,Organization 47,2016,Shelter Group 42,143,185,-42,1.2937062937062938
57,2023-08-11,1008,Organization 70,2001,Shelter Group 3,198,46,152,0.23232323232323232
58,2023-01-16,1043,Organization 90,2035,Shelter Group 2,140,154,-14,1.1
59,2023-04-26,1024,Organization 92,2032,Shelter Group 38,134,94,40,0.7014925373134329
60,2023-04-04,1005,Organization 70,2029,Shelter Group 32,57,167,-110,2.9298245614035086
61,2023-09-19,1014,Organization 4,2055,Shelter Group 11,66,195,-129,2.9545454545454546
62,2023-08-23,1097,Organization 64,2019,Shelter Group 12,139,16,123,0.11510791366906475
63,2023-03-27,1065,Organization 22,2058,Shelter Group 18,89,7,82,0.07865168539325842
64,2023-12-08,1099,Organization 79,2012,Shelter Group 30,140,147,-7,1.05
65,2023-02-08,1004,Organization 6,2082,Shelter Group 7,157,94,63,0.5987261146496815
66,2023-06-08,1035,Organization 57,2068,Shelter Group 13,173,136,37,0.7861271676300579
67,2023-08-28,1082,Organization 67,2021,Shelter Group 13,193,46,147,0.23834196891191708
68,2023-07-28,1010,Organization 85,2031,Shelter Group 11,146,62,84,0.4246575342465753
69,2023-11-02,1012,Organization 74,2061,Shelter Group 13,168,50,118,0.2976190476190476
70,2023-02-03,1048,Organization 89,2078,Shelter Group 21,95,41,54,0.43157894736842106
71,2023-01-04,1003,Organization 92,2072,Shelter Group 46,161,57,104,0.35403726708074534
72,2023-01-13,1026,Organization 65,2042,Shelter Group 10,73,168,-95,2.3013698630136985
73,2023-03-10,1076,Organization 35,2046,Shelter Group 16,172,100,72,0.5813953488372093
74,2023-08-31,1060,Organization 40,2031,Shelter Group 45,56,87,-31,1.5535714285714286
75,2023-11-04,1045,Organization 2,2051,Shelter Group 1,117,100,17,0.8547008547008547
76,2023-10-05,1008,Organization 46,2056,Shelter Group 7,96,10,86,0.10416666666666667
77,2023-03-30,1017,Organization 19,2042,Shelter Group 35,62,62,0,1
78,2023-01-25,1005,Organization 90,2019,Shelter Group 30,191,82,109,0.4293193717277487
79,2023-10-18,1083,Organization 33,2047,Shelter Group 16,196,82,114,0.41836734693877553
80,2023-10-13,1032,Organization 87,2081,Shelter Group 10,114,103,11,0.9035087719298246
81,2023-06-08,1002,Organization 3,2017,Shelter Group 17,55,183,-128,3.327272727272727
82,2023-05-01,1017,Organization 37,2034,Shelter Group 1,73,42,31,0.5753424657534246
83,2023-04-20,1049,Organization 64,2058,Shelter Group 36,84,125,-41,1.4880952380952381
84,2023-06-07,1072,Organization 88,2099,Shelter Group 25,84,115,-31,1.369047619047619
85,2023-03-05,1051,Organization 61,2091,Shelter Group 2,50,32,18,0.64
86,2023-07-18,1018,Organization 59,2049,Shelter Group 34,67,45,22,0.6716417910447762
87,2023-03-08,1026,Organization 64,2018,Shelter Group 37,127,52,75,0.4094488188976378
88,2023-05-31,1030,Organization 96,2067,Shelter Group 5,128,104,24,0.8125
89,2023-12-01,1083,Organization 13,2058,Shelter Group 46,126,63,63,0.5
90,2023-03-26,1069,Organization 73,2088,Shelter Group 7,144,197,-53,1.3680555555555556
91,2023-06-14,1093,Organization 17,2066,Shelter Group 34,130,16,114,0.12307692307692308
92,2023-05-16,1093,Organization 78,2045,Shelter Group 46,90,174,-84,1.9333333333333333
93,2023-02-20,1046,Organization 95,2067,Shelter Group 36,153,176,-23,1.1503267973856208
94,2023-03-15,1012,Organization 53,2016,Shelter Group 44,153,71,82,0.46405228758169936
95,2023-06-27,1056,Organization 8,2094,Shelter Group 40,161,25,136,0.15527950310559005
96,2023-12-28,1001,Organization 37,2021,Shelter Group 48,132,45,87,0.3409090909090909
97,2023-08-24,1048,Organization 12,2073,Shelter Group 19,93,180,-87,1.935483870967742
98,2023-04-08,1094,Organization 84,2042,Shelter Group 33,67,167,-100,2.4925373134328357
99,2023-11-26,1052,Organization 5,2090,Shelter Group 29,81,65,16,0.8024691358024691
100,2023-08-02,1007,Organization 57,2081,Shelter Group 20,99,101,-2,1.02020202020202
101,2023-05-07,1069,Organization 50,2046,Shelter Group 22,189,76,113,0.4021164021164021
102,2023-07-31,1010,Organization 51,2035,Shelter Group 15,60,38,22,0.6333333333333333
103,2023-06-23,1036,Organization 35,2036,Shelter Group 11,114,10,104,0.08771929824561403
104,2023-09-30,1008,Organization 5,2065,Shelter Group 50,89,170,-81,1.9101123595505618
105,2023-10-29,1049,Organization 72,2074,Shelter Group 49,131,118,13,0.9007633587786259
106,2023-11-06,1095,Organization 37,2087,Shelter Group 3,84,155,-71,1.8452380952380953
107,2023-08-20,1069,Organization 55,2026,Shelter Group 24,194,80,114,0.41237113402061853
108,2023-08-31,1039,Organization 26,2080,Shelter Group 4,113,91,22,0.8053097345132744
109,2023-12-16,1022,Organization 60,2094,Shelter Group 33,128,168,-40,1.3125
110,2023-12-01,1076,Organization 89,2021,Shelter Group 13,94,180,-86,1.9148936170212767
111,2023-10-07,1010,Organization 56,2036,Shelter Group 49,70,96,-26,1.3714285714285714
112,2023-04-23,1062,Organization 86,2025,Shelter Group 48,166,180,-14,1.0843373493975903
113,2023-04-17,1093,Organization 31,2087,Shelter Group 31,163,50,113,0.3067484662576687
114,2023-05-31,1094,Organization 52,2055,Shelter Group 6,74,197,-123,2.6621621621621623
115,2023-06-03,1065,Organization 9,2076,Shelter Group 7,171,5,166,0.029239766081871343
116,2023-04-12,1047,Organization 9,2055,Shelter Group 39,156,49,107,0.3141025641025641
117,2023-09-12,1014,Organization 53,2007,Shelter Group 21,176,35,141,0.19886363636363635
118,2023-06-09,1071,Organization 17,2021,Shelter Group 25,75,164,-89,2.1866666666666665
119,2023-06-04,1063,Organization 24,2089,Shelter Group 20,93,157,-64,1.6881720430107527
120,2023-01-05,1034,Organization 63,2024,Shelter Group 46,88,85,3,0.9659090909090909
121,2023-11-22,1074,Organization 61,2057,Shelter Group 47,79,179,-100,2.2658227848101267
122,2023-09-29,1079,Organization 75,2091,Shelter Group 5,117,200,-83,1.7094017094017093
123,2023-10-07,1019,Organization 96,2051,Shelter Group 31,119,129,-10,1.084033613445378
124,2023-10-15,1082,Organization 80,2038,Shelter Group 48,112,82,30,0.7321428571428571
125,2023-10-04,1022,Organization 27,2051,Shelter Group 33,70,191,-121,2.7285714285714286
126,2023-02-24,1018,Organization 28,2092,Shelter Group 10,112,198,-86,1.7678571428571428
127,2023-11-27,1051,Organization 95,2059,Shelter Group 15,178,72,106,0.4044943820224719
128,2023-08-26,1067,Organization 14,2018,Shelter Group 29,105,151,-46,1.438095238095238
129,2023-09-09,1052,Organization 13,2014,Shelter Group 21,137,82,55,0.5985401459854015
130,2023-12-05,1063,Organization 47,2090,Shelter Group 4,146,45,101,0.3082191780821918
131,2023-02-08,1037,Organization 14,2048,Shelter Group 47,126,21,105,0.16666666666666666
132,2023-11-06,1018,Organization 95,2043,Shelter Group 31,152,18,134,0.11842105263157894
133,2023-05-17,1041,Organization 74,2049,Shelter Group 18,63,172,-109,2.7301587301587302
134,2023-08-14,1065,Organization 93,2040,Shelter Group 9,89,115,-26,1.2921348314606742
135,2023-02-17,1039,Organization 92,2029,Shelter Group 32,132,136,-4,1.0303030303030303
136,2023-03-18,1015,Organization 9,2023,Shelter Group 33,179,169,10,0.9441340782122905
137,2023-03-24,1049,Organization 77,2071,Shelter Group 33,104,35,69,0.33653846153846156
138,2023-07-03,1070,Organization 78,2004,Shelter Group 27,186,10,176,0.053763440860215055
139,2023-02-08,1097,Organization 48,2076,Shelter Group 8,50,171,-121,3.42
140,2023-07-15,1040,Organization 69,2060,Shelter Group 21,98,23,75,0.23469387755102042
141,2023-09-14,1074,Organization 90,2082,Shelter Group 49,125,61,64,0.488
142,2023-06-17,1060,Organization 77,2026,Shelter Group 35,161,55,106,0.3416149068322981
143,2023-10-13,1034,Organization 78,2017,Shelter Group 28,196,50,146,0.25510204081632654
144,2023-04-04,1090,Organization 72,2060,Shelter Group 18,90,125,-35,1.3888888888888888
145,2023-09-29,1018,Organization 71,2030,Shelter Group 24,57,112,-55,1.9649122807017543
146,2023-12-10,1069,Organization 99,2033,Shelter Group 32,129,165,-36,1.2790697674418605
147,2023-11-06,1060,Organization 59,2038,Shelter Group 37,65,187,-122,2.876923076923077
148,2023-01-20,1035,Organization 64,2034,Shelter Group 4,112,141,-29,1.2589285714285714
149,2023-12-26,1070,Organization 45,2042,Shelter Group 32,97,128,-31,1.3195876288659794
150,2023-07-14,1093,Organization 57,2050,Shelter Group 40,72,146,-74,2.0277777777777777
151,2023-12-15,1054,Organization 46,2097,Shelter Group 16,133,53,80,0.39849624060150374
152,2023-06-13,1043,Organization 77,2088,Shelter Group 30,142,72,70,0.5070422535211268
153,2023-02-21,1073,Organization 57,2034,Shelter Group 4,96,56,40,0.5833333333333334
154,2023-12-30,1022,Organization 45,2085,Shelter Group 10,116,83,33,0.7155172413793104
155,2023-01-22,1020,Organization 82,2042,Shelter Group 45,55,32,23,0.5818181818181818
156,2023-06-26,1047,Organization 20,2075,Shelter Group 25,133,104,29,0.7819548872180451
157,2023-02-11,1094,Organization 96,2030,Shelter Group 48,81,132,-51,1.6296296296296295
158,2023-11-11,1041,Organization 43,2008,Shelter Group 19,188,104,84,0.5531914893617021
159,2023-03-25,1014,Organization 72,2093,Shelter Group 39,59,167,-108,2.830508474576271
160,2023-01-11,1029,Organization 8,2098,Shelter Group 25,119,196,-77,1.6470588235294117
161,2023-05-01,1011,Organization 15,2060,Shelter Group 24,93,157,-64,1.6881720430107527
162,2023-10-29,1060,Organization 97,2055,Shelter Group 38,173,86,87,0.49710982658959535
163,2023-03-26,1020,Organization 21,2078,Shelter Group 19,68,33,35,0.4852941176470588
164,2023-12-31,1081,Organization 50,2004,Shelter Group 35,95,29,66,0.30526315789473685
165,2023-07-13,1088,Organization 81,2026,Shelter Group 40,191,91,100,0.47643979057591623
166,2023-04-17,1051,Organization 58,2050,Shelter Group 50,108,144,-36,1.3333333333333333
167,2023-03-18,1089,Organization 61,2036,Shelter Group 14,192,171,21,0.890625
168,2023-07-17,1013,Organization 33,2081,Shelter Group 50,97,27,70,0.27835051546391754
169,2023-09-06,1076,Organization 61,2010,Shelter Group 42,90,176,-86,1.9555555555555555
170,2023-07-19,1006,Organization 23,2051,Shelter Group 47,138,200,-62,1.4492753623188406
171,2023-06-09,1067,Organization 70,2058,Shelter Group 12,86,14,72,0.16279069767441862
172,2023-09-07,1092,Organization 81,2065,Shelter Group 19,184,52,132,0.2826086956521739
173,2023-10-19,1044,Organization 28,2014,Shelter Group 12,67,180,-113,2.6865671641791047
174,2023-01-16,1011,Organization 4,2069,Shelter Group 47,84,183,-99,2.1785714285714284
175,2023-02-02,1019,Organization 10,2077,Shelter Group 44,147,197,-50,1.3401360544217686
176,2023-02-09,1011,Organization 29,2079,Shelter Group 6,106,132,-26,1.2452830188679245
177,2023-01-10,1063,Organization 47,2052,Shelter Group 44,200,156,44,0.78
178,2023-07-19,1100,Organization 87,2092,Shelter Group 2,57,31,26,0.543859649122807
179,2023-05-05,1022,Organization 2,2060,Shelter Group 43,188,57,131,0.30319148936170215
180,2023-09-22,1011,Organization 92,2084,Shelter Group 19,123,32,91,0.2601626016260163
181,2023-09-20,1027,Organization 7,2020,Shelter Group 46,155,149,6,0.9612903225806452
182,2023-07-05,1002,Organization 82,2071,Shelter Group 12,181,114,67,0.6298342541436464
183,2023-03-02,1006,Organization 41,2032,Shelter Group 50,50,65,-15,1.3
184,2023-09-09,1100,Organization 1,2044,Shelter Group 18,81,54,27,0.6666666666666666
185,2023-06-01,1055,Organization 11,2021,Shelter Group 29,198,132,66,0.6666666666666666
186,2023-11-15,1048,Organization 72,2056,Shelter Group 49,107,144,-37,1.3457943925233644
187,2023-02-23,1028,Organization 14,2032,Shelter Group 24,62,58,4,0.9354838709677419
188,2023-01-26,1029,Organization 8,2050,Shelter Group 21,142,136,6,0.9577464788732394
189,2023-08-23,1068,Organization 8,2039,Shelter Group 41,80,128,-48,1.6
190,2023-10-16,1041,Organization 71,2036,Shelter Group 19,54,2,52,0.037037037037037035
191,2023-07-04,1005,Organization 63,2043,Shelter Group 35,64,138,-74,2.15625
192,2023-09-10,1095,Organization 63,2094,Shelter Group 50,113,10,103,0.08849557522123894
193,2023-04-25,1009,Organization 50,2034,Shelter Group 17,50,176,-126,3.52
194,2023-01-10,1083,Organization 8,2099,Shelter Group 27,86,157,-71,1.8255813953488371
195,2023-11-05,1028,Organization 73,2099,Shelter Group 11,62,100,-38,1.6129032258064515
196,2023-02-23,1015,Organization 38,2005,Shelter Group 32,164,28,136,0.17073170731707318
197,2023-07-24,1060,Organization 61,2037,Shelter Group 40,156,167,-11,1.0705128205128205
198,2023-12-29,1075,Organization 48,2047,Shelter Group 15,145,142,3,0.9793103448275862
199,2023-09-24,1093,Organization 59,2004,Shelter Group 15,182,142,40,0.7802197802197802
200,2023-01-25,1017,Organization 37,2098,Shelter Group 23,130,145,-15,1.1153846153846154
201,2023-02-21,1061,Organization 56,2018,Shelter Group 8,172,126,46,0.7325581395348837
202,2023-10-09,1041,Organization 52,2038,Shelter Group 26,200,113,87,0.565
203,2023-08-03,1025,Organization 73,2035,Shelter Group 49,65,53,12,0.8153846153846154
204,2023-12-12,1076,Organization 3,2093,Shelter Group 39,81,33,48,0.4074074074074074
205,2023-06-09,1019,Organization 34,2087,Shelter Group 44,154,166,-12,1.077922077922078
206,2023-02-26,1052,Organization 99,2074,Shelter Group 18,140,28,112,0.2
207,2023-04-15,1071,Organization 1,2082,Shelter Group 38,144,198,-54,1.375
208,2023-12-23,1011,Organization 40,2066,Shelter Group 50,189,54,135,0.2857142857142857
209,2023-10-06,1015,Organization 58,2055,Shelter Group 20,112,94,18,0.8392857142857143
210,2023-09-27,1073,Organization 3,2098,Shelter Group 50,116,72,44,0.6206896551724138
211,2023-05-14,1088,Organization 96,2097,Shelter Group 22,189,117,72,0.6190476190476191
212,2023-12-13,1083,Organization 6,2072,Shelter Group 46,186,194,-8,1.043010752688172
213,2023-05-09,1011,Organization 79,2086,Shelter Group 14,102,107,-5,1.0490196078431373
214,2023-08-06,1033,Organization 81,2082,Shelter Group 32,194,82,112,0.422680412371134
215,2023-04-16,1073,Organization 95,2100,Shelter Group 6,108,18,90,0.16666666666666666
216,2023-07-05,1023,Organization 20,2006,Shelter Group 3,73,68,5,0.9315068493150684
217,2023-12-03,1017,Organization 19,2054,Shelter Group 2,75,119,-44,1.5866666666666667
218,2023-10-12,1010,Organization 18,2041,Shelter Group 8,178,86,92,0.48314606741573035
219,2023-01-26,1072,Organization 99,2077,Shelter Group 31,60,131,-71,2.183333333333333
220,2023-01-27,1018,Organization 16,2014,Shelter Group 44,136,40,96,0.29411764705882354
221,2023-01-07,1024,Organization 93,2089,Shelter Group 25,166,88,78,0.5301204819277109
222,2023-09-02,1089,Organization 11,2077,Shelter Group 29,52,123,-71,2.3653846153846154
223,2023-06-03,1050,Organization 69,2100,Shelter Group 28,135,4,131,0.02962962962962963
224,2023-02-10,1071,Organization 76,2009,Shelter Group 50,87,131,-44,1.5057471264367817
225,2023-07-31,1012,Organization 67,2086,Shelter Group 29,182,176,6,0.967032967032967
226,2023-08-10,1080,Organization 38,2034,Shelter Group 1,197,133,64,0.6751269035532995
227,2023-06-08,1003,Organization 36,2076,Shelter Group 31,169,184,-15,1.0887573964497042
228,2023-12-15,1031,Organization 94,2041,Shelter Group 25,195,127,68,0.6512820512820513
229,2023-05-25,1099,Organization 28,2009,Shelter Group 40,157,102,55,0.6496815286624203
230,2023-02-26,1021,Organization 55,2082,Shelter Group 6,79,60,19,0.759493670886076
231,2023-05-28,1062,Organization 61,2031,Shelter Group 20,106,124,-18,1.169811320754717
232,2023-06-12,1034,Organization 21,2009,Shelter Group 28,177,82,95,0.4632768361581921
233,2023-08-26,1028,Organization 96,2089,Shelter Group 50,200,35,165,0.175
234,2023-06-10,1036,Organization 10,2098,Shelter Group 10,144,48,96,0.3333333333333333
235,2023-03-07,1026,Organization 20,2098,Shelter Group 5,99,32,67,0.32323232323232326
236,2023-01-04,1001,Organization 41,2058,Shelter Group 13,152,181,-29,1.1907894736842106
237,2023-11-26,1090,Organization 47,2037,Shelter Group 9,91,16,75,0.17582417582417584
238,2023-08-13,1021,Organization 30,2066,Shelter Group 46,161,150,11,0.9316770186335404
239,2023-04-27,1042,Organization 50,2020,Shelter Group 29,110,62,48,0.5636363636363636
240,2023-01-25,1085,Organization 75,2063,Shelter Group 32,169,1,168,0.005917159763313609
241,2023-05-16,1035,Organization 28,2100,Shelter Group 46,87,90,-3,1.0344827586206897
242,2023-02-24,1094,Organization 82,2084,Shelter Group 34,58,71,-13,1.2241379310344827
243,2023-08-05,1012,Organization 66,2084,Shelter Group 12,106,64,42,0.6037735849056604
244,2023-03-26,1097,Organization 21,2040,Shelter Group 30,166,60,106,0.3614457831325301
245,2023-02-14,1013,Organization 58,2016,Shelter Group 10,120,73,47,0.6083333333333333
246,2023-05-26,1050,Organization 55,2063,Shelter Group 41,79,3,76,0.0379746835443038
247,2023-06-19,1064,Organization 19,2002,Shelter Group 10,185,59,126,0.31891891891891894
248,2023-05-14,1033,Organization 15,2044,Shelter Group 10,170,29,141,0.17058823529411765
249,2023-07-18,1024,Organization 92,2016,Shelter Group 25,198,166,32,0.8383838383838383
250,2023-12-27,1009,Organization 88,2020,Shelter Group 10,115,87,28,0.7565217391304347
251,2023-06-25,1031,Organization 98,2065,Shelter Group 26,172,160,12,0.9302325581395349
252,2023-09-02,1096,Organization 42,2017,Shelter Group 7,177,23,154,0.12994350282485875
253,2023-11-05,1066,Organization 53,2009,Shelter Group 17,141,106,35,0.75177304964539
254,2023-04-14,1031,Organization 84,2038,Shelter Group 31,138,172,-34,1.2463768115942029
255,2023-11-05,1060,Organization 69,2032,Shelter Group 49,163,123,40,0.754601226993865
256,2023-11-15,1091,Organization 18,2089,Shelter Group 41,156,62,94,0.3974358974358974
257,2023-07-18,1099,Organization 91,2074,Shelter Group 32,187,55,132,0.29411764705882354
258,2023-07-29,1097,Organization 41,2090,Shelter Group 23,86,68,18,0.7906976744186046
259,2023-12-15,1023,Organization 95,2048,Shelter Group 38,123,184,-61,1.4959349593495934
260,2023-08-13,1037,Organization 75,2032,Shelter Group 35,168,197,-29,1.1726190476190477
261,2023-09-15,1074,Organization 93,2019,Shelter Group 4,165,59,106,0.3575757575757576
262,2023-06-26,1043,Organization 65,2075,Shelter Group 39,72,134,-62,1.8611111111111112
263,2023-05-21,1019,Organization 7,2079,Shelter Group 4,77,124,-47,1.6103896103896105
264,2023-01-24,1016,Organization 46,2007,Shelter Group 36,141,140,1,0.9929078014184397
265,2023-05-10,1039,Organization 35,2092,Shelter Group 23,86,12,74,0.13953488372093023
266,2023-06-14,1096,Organization 13,2003,Shelter Group 45,173,8,165,0.046242774566473986
267,2023-07-10,1050,Organization 80,2060,Shelter Group 33,135,50,85,0.37037037037037035
268,2023-03-17,1019,Organization 28,2082,Shelter Group 7,114,124,-10,1.087719298245614
269,2023-09-26,1004,Organization 97,2051,Shelter Group 18,181,2,179,0.011049723756906077
270,2023-06-19,1051,Organization 8,2018,Shelter Group 40,85,76,9,0.8941176470588236
271,2023-07-17,1035,Organization 51,2025,Shelter Group 46,198,158,40,0.797979797979798
272,2023-12-28,1034,Organization 68,2018,Shelter Group 37,153,85,68,0.5555555555555556
273,2023-08-22,1029,Organization 43,2097,Shelter Group 1,129,106,23,0.8217054263565892
274,2023-03-05,1077,Organization 56,2094,Shelter Group 35,144,184,-40,1.2777777777777777
275,2023-03-21,1100,Organization 11,2004,Shelter Group 7,71,19,52,0.2676056338028169
276,2023-02-05,1084,Organization 10,2010,Shelter Group 1,138,128,10,0.927536231884058
277,2023-10-18,1054,Organization 71,2019,Shelter Group 29,150,84,66,0.56
278,2023-09-10,1067,Organization 85,2038,Shelter Group 30,193,31,162,0.16062176165803108
279,2023-12-09,1089,Organization 64,2021,Shelter Group 7,92,174,-82,1.891304347826087
280,2023-11-19,1085,Organization 46,2036,Shelter Group 40,128,199,-71,1.5546875
281,2023-02-17,1053,Organization 75,2072,Shelter Group 48,156,91,65,0.5833333333333334
282,2023-04-21,1040,Organization 2,2071,Shelter Group 13,133,23,110,0.17293233082706766
283,2023-10-06,1005,Organization 77,2033,Shelter Group 2,191,38,153,0.19895287958115182
284,2023-11-13,1005,Organization 59,2034,Shelter Group 22,58,176,-118,3.0344827586206895
285,2023-10-22,1083,Organization 25,2013,Shelter Group 13,141,61,80,0.4326241134751773
286,2023-08-10,1094,Organization 23,2099,Shelter Group 16,175,180,-5,1.0285714285714285
287,2023-10-14,1071,Organization 20,2032,Shelter Group 45,168,123,45,0.7321428571428571
288,2023-08-10,1017,Organization 68,2012,Shelter Group 39,69,78,-9,1.1304347826086956
289,2023-03-14,1093,Organization 35,2004,Shelter Group 29,87,127,-40,1.4597701149425288
290,2023-10-19,1098,Organization 74,2089,Shelter Group 1,102,47,55,0.46078431372549017
291,2023-08-14,1017,Organization 52,2091,Shelter Group 39,189,65,124,0.3439153439153439
292,2023-10-05,1061,Organization 1,2051,Shelter Group 14,150,145,5,0.9666666666666667
293,2023-06-21,1011,Organization 84,2076,Shelter Group 33,130,27,103,0.2076923076923077
294,2023-10-24,1014,Organization 83,2001,Shelter Group 34,148,190,-42,1.2837837837837838
295,2023-12-14,1033,Organization 39,2089,Shelter Group 13,140,187,-47,1.3357142857142856
296,2023-04-03,1034,Organization 39,2081,Shelter Group 48,160,29,131,0.18125
297,2023-05-05,1064,Organization 96,2016,Shelter Group 45,174,163,11,0.9367816091954023
298,2023-10-26,1010,Organization 96,2002,Shelter Group 3,175,109,66,0.6228571428571429
299,2023-02-08,1098,Organization 63,2071,Shelter Group 27,160,189,-29,1.18125
300,2023-08-25,1038,Organization 37,2064,Shelter Group 24,55,45,10,0.8181818181818182
301,2023-06-14,1077,Organization 42,2031,Shelter Group 17,117,89,28,0.7606837606837606
302,2023-04-17,1012,Organization 59,2059,Shelter Group 19,92,75,17,0.8152173913043478
303,2023-02-02,1035,Organization 48,2046,Shelter Group 25,192,111,81,0.578125
304,2023-03-24,1059,Organization 31,2059,Shelter Group 20,82,113,-31,1.3780487804878048
305,2023-12-20,1033,Organization 86,2015,Shelter Group 35,50,1,49,0.02
306,2023-10-04,1043,Organization 59,2016,Shelter Group 14,144,67,77,0.4652777777777778
307,2023-07-28,1011,Organization 53,2094,Shelter Group 11,157,179,-22,1.1401273885350318
308,2023-03-17,1072,Organization 85,2039,Shelter Group 4,173,31,142,0.1791907514450867
309,2023-04-04,1081,Organization 92,2100,Shelter Group 21,115,126,-11,1.0956521739130434
310,2023-10-18,1004,Organization 47,2032,Shelter Group 18,147,30,117,0.20408163265306123
311,2023-01-30,1076,Organization 14,2068,Shelter Group 46,100,120,-20,1.2
312,2023-08-05,1047,Organization 89,2074,Shelter Group 45,63,110,-47,1.746031746031746
313,2023-06-24,1056,Organization 33,2010,Shelter Group 22,189,181,8,0.9576719576719577
314,2023-11-19,1014,Organization 37,2065,Shelter Group 36,96,8,88,0.08333333333333333
315,2023-04-25,1051,Organization 12,2046,Shelter Group 39,113,160,-47,1.415929203539823
316,2023-12-04,1027,Organization 84,2093,Shelter Group 3,66,80,-14,1.2121212121212122
317,2023-04-06,1075,Organization 71,2100,Shelter Group 30,164,167,-3,1.0182926829268293
318,2023-12-24,1049,Organization 92,2040,Shelter Group 40,93,170,-77,1.8279569892473118
319,2023-06-19,1029,Organization 97,2075,Shelter Group 23,172,169,3,0.9825581395348837
320,2023-04-06,1038,Organization 22,2006,Shelter Group 34,184,53,131,0.28804347826086957
321,2023-01-26,1019,Organization 23,2049,Shelter Group 17,142,177,-35,1.2464788732394365
322,2023-08-18,1021,Organization 87,2012,Shelter Group 11,192,132,60,0.6875
323,2023-05-28,1049,Organization 87,2055,Shelter Group 7,128,162,-34,1.265625
324,2023-12-16,1006,Organization 20,2029,Shelter Group 28,190,151,39,0.7947368421052632
325,2023-07-21,1069,Organization 10,2001,Shelter Group 49,172,27,145,0.1569767441860465
326,2023-03-22,1088,Organization 67,2067,Shelter Group 34,182,60,122,0.32967032967032966
327,2023-12-04,1016,Organization 9,2070,Shelter Group 6,192,59,133,0.3072916666666667
328,2023-08-20,1073,Organization 27,2092,Shelter Group 12,110,160,-50,1.4545454545454546
329,2023-08-31,1078,Organization 75,2002,Shelter Group 13,191,75,116,0.39267015706806285
330,2023-04-16,1062,Organization 17,2072,Shelter Group 12,179,15,164,0.08379888268156424
331,2023-01-11,1069,Organization 68,2095,Shelter Group 13,85,120,-35,1.411764705882353
332,2023-04-23,1030,Organization 92,2098,Shelter Group 1,146,51,95,0.3493150684931507
333,2023-12-30,1062,Organization 63,2052,Shelter Group 40,72,81,-9,1.125
334,2023-05-21,1045,Organization 95,2049,Shelter Group 40,190,11,179,0.05789473684210526
335,2023-01-31,1068,Organization 33,2064,Shelter Group 36,192,187,5,0.9739583333333334
336,2023-04-25,1068,Organization 43,2036,Shelter Group 25,192,189,3,0.984375
337,2023-10-05,1096,Organization 97,2071,Shelter Group 32,197,134,63,0.6802030456852792
338,2023-04-04,1092,Organization 94,2090,Shelter Group 9,197,62,135,0.3147208121827411
339,2023-07-21,1085,Organization 23,2063,Shelter Group 4,71,78,-7,1.0985915492957747
340,2023-01-16,1052,Organization 81,2061,Shelter Group 33,167,112,55,0.6706586826347305
341,2023-07-16,1070,Organization 40,2050,Shelter Group 47,108,138,-30,1.2777777777777777
342,2023-06-27,1042,Organization 17,2084,Shelter Group 48,126,66,60,0.5238095238095238
343,2023-06-26,1020,Organization 68,2016,Shelter Group 48,59,74,-15,1.2542372881355932
344,2023-01-12,1081,Organization 87,2024,Shelter Group 45,113,27,86,0.23893805309734514
345,2023-03-07,1075,Organization 51,2001,Shelter Group 22,119,178,-59,1.495798319327731
346,2023-02-19,1040,Organization 23,2006,Shelter Group 5,80,4,76,0.05
347,2023-07-23,1021,Organization 92,2072,Shelter Group 11,107,31,76,0.2897196261682243
348,2023-06-24,1096,Organization 16,2067,Shelter Group 42,109,144,-35,1.3211009174311927
349,2023-05-14,1058,Organization 12,2070,Shelter Group 25,198,99,99,0.5
350,2023-05-02,1083,Organization 96,2016,Shelter Group 27,86,9,77,0.10465116279069768
351,2023-11-11,1043,Organization 54,2034,Shelter Group 16,177,13,164,0.07344632768361582
352,2023-09-16,1001,Organization 3,2014,Shelter Group 42,112,67,45,0.5982142857142857
353,2023-12-19,1034,Organization 7,2059,Shelter Group 44,199,84,115,0.4221105527638191
354,2023-09-05,1076,Organization 3,2070,Shelter Group 45,95,171,-76,1.8
355,2023-10-16,1014,Organization 53,2023,Shelter Group 26,167,174,-7,1.0419161676646707
356,2023-02-17,1067,Organization 20,2085,Shelter Group 47,195,17,178,0.08717948717948718
357,2023-11-27,1048,Organization 19,2001,Shelter Group 12,54,164,-110,3.037037037037037
358,2023-04-10,1020,Organization 61,2086,Shelter Group 35,105,20,85,0.19047619047619047
359,2023-04-18,1090,Organization 4,2068,Shelter Group 23,66,32,34,0.48484848484848486
360,2023-10-28,1004,Organization 26,2027,Shelter Group 36,174,79,95,0.4540229885057471
361,2023-01-10,1004,Organization 8,2043,Shelter Group 39,83,123,-40,1.4819277108433735
362,2023-06-19,1090,Organization 49,2094,Shelter Group 5,181,24,157,0.13259668508287292
363,2023-10-07,1065,Organization 58,2030,Shelter Group 17,145,53,92,0.36551724137931035
364,2023-12-14,1089,Organization 15,2066,Shelter Group 33,76,134,-58,1.763157894736842
365,2023-07-28,1081,Organization 89,2020,Shelter Group 36,57,120,-63,2.1052631578947367
366,2023-11-11,1085,Organization 73,2020,Shelter Group 17,116,19,97,0.16379310344827586
367,2023-05-17,1036,Organization 13,2064,Shelter Group 18,53,27,26,0.5094339622641509
368,2023-11-05,1017,Organization 61,2001,Shelter Group 44,123,163,-40,1.3252032520325203
369,2023-04-18,1039,Organization 31,2032,Shelter Group 20,131,182,-51,1.3893129770992367
370,2023-01-08,1059,Organization 43,2074,Shelter Group 9,73,116,-43,1.5890410958904109
371,2023-04-24,1069,Organization 5,2057,Shelter Group 2,54,58,-4,1.0740740740740742
372,2023-09-18,1093,Organization 24,2078,Shelter Group 44,118,169,-51,1.4322033898305084
373,2023-01-29,1009,Organization 86,2065,Shelter Group 26,142,5,137,0.035211267605633804
374,2023-11-02,1031,Organization 97,2039,Shelter Group 3,66,150,-84,2.272727272727273
375,2023-11-22,1070,Organization 98,2011,Shelter Group 5,199,156,43,0.7839195979899497
376,2023-03-15,1041,Organization 36,2039,Shelter Group 22,114,97,17,0.8508771929824561
377,2023-10-09,1031,Organization 59,2029,Shelter Group 32,63,72,-9,1.1428571428571428
378,2023-03-14,1035,Organization 38,2046,Shelter Group 26,189,189,0,1
379,2023-09-24,1073,Organization 69,2091,Shelter Group 1,95,110,-15,1.1578947368421053
380,2023-09-19,1049,Organization 91,2061,Shelter Group 6,141,195,-54,1.3829787234042554
381,2023-08-12,1099,Organization 61,2069,Shelter Group 9,100,73,27,0.73
382,2023-07-23,1038,Organization 19,2086,Shelter Group 46,192,61,131,0.3177083333333333
383,2023-07-30,1082,Organization 12,2058,Shelter Group 21,196,176,20,0.8979591836734694
384,2023-08-07,1017,Organization 33,2046,Shelter Group 46,74,1,73,0.013513513513513514
385,2023-07-03,1077,Organization 74,2044,Shelter Group 49,70,77,-7,1.1
386,2023-12-18,1047,Organization 31,2040,Shelter Group 22,138,168,-30,1.2173913043478262
387,2023-06-04,1093,Organization 36,2032,Shelter Group 40,128,42,86,0.328125
388,2023-04-29,1053,Organization 74,2071,Shelter Group 18,142,156,-14,1.0985915492957747
389,2023-12-10,1016,Organization 15,2086,Shelter Group 25,153,42,111,0.27450980392156865
390,2023-03-08,1097,Organization 28,2100,Shelter Group 11,195,142,53,0.7282051282051282
391,2023-04-20,1015,Organization 100,2097,Shelter Group 20,185,109,76,0.5891891891891892
392,2023-05-14,1091,Organization 90,2034,Shelter Group 27,98,29,69,0.29591836734693877
393,2023-02-05,1022,Organization 8,2001,Shelter Group 9,168,0,168,0
394,2023-02-24,1008,Organization 86,2011,Shelter Group 37,177,85,92,0.480225988700565
395,2023-08-28,1065,Organization 46,2040,Shelter Group 10,98,152,-54,1.5510204081632653
396,2023-04-30,1070,Organization 60,2048,Shelter Group 36,92,193,-101,2.097826086956522
397,2023-12-16,1086,Organization 72,2013,Shelter Group 18,175,10,165,0.05714285714285714
398,2023-10-31,1070,Organization 42,2017,Shelter Group 35,146,104,42,0.7123287671232876
399,2023-01-10,1005,Organization 70,2011,Shelter Group 20,149,32,117,0.21476510067114093
400,2023-06-02,1090,Organization 68,2064,Shelter Group 11,191,64,127,0.33507853403141363
401,2023-04-10,1009,Organization 43,2058,Shelter Group 40,130,188,-58,1.4461538461538461
402,2023-04-15,1031,Organization 80,2074,Shelter Group 27,174,40,134,0.22988505747126436
403,2023-10-08,1067,Organization 63,2050,Shelter Group 35,74,197,-123,2.6621621621621623
404,2023-06-29,1041,Organization 40,2014,Shelter Group 17,137,144,-7,1.051094890510949
405,2023-10-05,1032,Organization 95,2012,Shelter Group 34,137,83,54,0.6058394160583942
406,2023-08-29,1053,Organization 90,2096,Shelter Group 19,171,21,150,0.12280701754385964
407,2023-01-24,1023,Organization 46,2073,Shelter Group 23,89,106,-17,1.1910112359550562
408,2023-06-16,1082,Organization 20,2004,Shelter Group 35,182,101,81,0.554945054945055
409,2023-02-16,1086,Organization 7,2059,Shelter Group 29,138,177,-39,1.2826086956521738
410,2023-07-10,1058,Organization 73,2043,Shelter Group 28,167,158,9,0.9461077844311377
411,2023-02-06,1023,Organization 84,2027,Shelter Group 42,161,142,19,0.8819875776397516
412,2023-06-23,1025,Organization 53,2100,Shelter Group 13,168,108,60,0.6428571428571429
413,2023-02-23,1038,Organization 11,2050,Shelter Group 49,199,94,105,0.4723618090452261
414,2023-10-30,1030,Organization 49,2076,Shelter Group 18,62,179,-117,2.8870967741935485
415,2023-07-26,1038,Organization 2,2009,Shelter Group 20,143,189,-46,1.3216783216783217
416,2023-01-19,1004,Organization 29,2016,Shelter Group 47,132,81,51,0.6136363636363636
417,2023-07-19,1081,Organization 87,2028,Shelter Group 26,152,22,130,0.14473684210526316
418,2023-06-08,1070,Organization 37,2092,Shelter Group 34,126,46,80,0.36507936507936506
419,2023-02-06,1026,Organization 85,2077,Shelter Group 35,63,43,20,0.6825396825396826
420,2023-04-13,1039,Organization 30,2071,Shelter Group 38,161,171,-10,1.062111801242236
421,2023-09-01,1096,Organization 52,2003,Shelter Group 6,176,143,33,0.8125
422,2023-02-17,1027,Organization 6,2087,Shelter Group 27,148,179,-31,1.2094594594594594
423,2023-07-07,1062,Organization 63,2012,Shelter Group 50,196,3,193,0.015306122448979591
424,2023-05-19,1075,Organization 55,2088,Shelter Group 9,143,170,-27,1.1888111888111887
425,2023-10-26,1021,Organization 96,2020,Shelter Group 37,81,175,-94,2.1604938271604937
426,2023-06-07,1097,Organization 35,2016,Shelter Group 14,65,88,-23,1.353846153846154
427,2023-07-08,1072,Organization 27,2033,Shelter Group 18,106,133,-27,1.2547169811320755
428,2023-11-07,1017,Organization 78,2043,Shelter Group 50,115,32,83,0.2782608695652174
429,2023-07-08,1094,Organization 41,2065,Shelter Group 3,165,38,127,0.23030303030303031
430,2023-02-26,1078,Organization 60,2052,Shelter Group 21,179,10,169,0.055865921787709494
431,2023-02-07,1024,Organization 32,2016,Shelter Group 4,73,108,-35,1.4794520547945205
432,2023-03-25,1007,Organization 60,2035,Shelter Group 31,171,16,155,0.0935672514619883
433,2023-11-15,1067,Organization 84,2015,Shelter Group 17,184,73,111,0.3967391304347826
434,2023-06-23,1033,Organization 86,2089,Shelter Group 16,147,145,2,0.9863945578231292
435,2023-11-30,1088,Organization 4,2040,Shelter Group 44,57,95,-38,1.6666666666666667
436,2023-11-22,1079,Organization 51,2017,Shelter Group 22,167,147,20,0.8802395209580839
437,2023-05-10,1091,Organization 94,2022,Shelter Group 31,91,0,91,0
438,2023-04-30,1024,Organization 40,2030,Shelter Group 19,180,15,165,0.08333333333333333
439,2023-07-19,1087,Organization 38,2041,Shelter Group 43,58,43,15,0.7413793103448276
440,2023-11-27,1046,Organization 34,2013,Shelter Group 49,174,159,15,0.9137931034482759
441,2023-01-21,1027,Organization 18,2057,Shelter Group 43,96,146,-50,1.5208333333333333
442,2023-07-18,1012,Organization 86,2001,Shelter Group 17,98,151,-53,1.5408163265306123
443,2023-03-28,1049,Organization 35,2052,Shelter Group 31,131,4,127,0.030534351145038167
444,2023-03-13,1008,Organization 30,2076,Shelter Group 35,148,126,22,0.8513513513513513
445,2023-11-11,1097,Organization 3,2031,Shelter Group 42,65,28,37,0.4307692307692308
446,2023-07-21,1086,Organization 72,2064,Shelter Group 44,91,82,9,0.9010989010989011
447,2023-06-14,1098,Organization 73,2094,Shelter Group 25,85,164,-79,1.9294117647058824
448,2023-03-22,1005,Organization 32,2034,Shelter Group 14,134,14,120,0.1044776119402985
449,2023-02-24,1077,Organization 95,2042,Shelter Group 15,80,8,72,0.1
450,2023-05-14,1083,Organization 30,2005,Shelter Group 50,98,102,-4,1.0408163265306123
451,2023-09-01,1095,Organization 25,2003,Shelter Group 23,110,148,-38,1.3454545454545455
452,2023-01-06,1026,Organization 44,2005,Shelter Group 34,85,92,-7,1.0823529411764705
453,2023-05-08,1020,Organization 19,2077,Shelter Group 10,176,5,171,0.028409090909090908
454,2023-06-05,1029,Organization 66,2079,Shelter Group 10,60,128,-68,2.1333333333333333
455,2023-10-15,1056,Organization 44,2006,Shelter Group 18,123,25,98,0.2032520325203252
456,2023-02-18,1009,Organization 85,2065,Shelter Group 43,149,146,3,0.9798657718120806
457,2023-08-15,1080,Organization 18,2074,Shelter Group 44,105,142,-37,1.3523809523809525
458,2023-08-27,1085,Organization 74,2055,Shelter Group 5,93,42,51,0.45161290322580644
459,2023-12-06,1097,Organization 51,2025,Shelter Group 37,53,13,40,0.24528301886792453
460,2023-07-12,1049,Organization 47,2043,Shelter Group 9,91,174,-83,1.9120879120879122
461,2023-07-16,1050,Organization 47,2020,Shelter Group 29,163,93,70,0.5705521472392638
462,2023-10-30,1042,Organization 3,2082,Shelter Group 3,109,178,-69,1.6330275229357798
463,2023-05-28,1073,Organization 70,2015,Shelter Group 43,68,170,-102,2.5
464,2023-07-09,1011,Organization 48,2090,Shelter Group 26,66,115,-49,1.7424242424242424
465,2023-04-22,1065,Organization 55,2039,Shelter Group 28,158,166,-8,1.0506329113924051
466,2023-07-10,1098,Organization 44,2003,Shelter Group 14,95,168,-73,1.768421052631579
467,2023-04-29,1075,Organization 31,2088,Shelter Group 49,185,158,27,0.8540540540540541
468,2023-04-25,1089,Organization 47,2061,Shelter Group 45,102,117,-15,1.1470588235294117
469,2023-01-10,1062,Organization 52,2019,Shelter Group 12,92,78,14,0.8478260869565217
470,2023-04-25,1078,Organization 97,2037,Shelter Group 14,150,34,116,0.22666666666666666
471,2023-02-28,1095,Organization 61,2047,Shelter Group 21,159,181,-22,1.1383647798742138
472,2023-11-01,1014,Organization 20,2083,Shelter Group 10,53,35,18,0.660377358490566
473,2023-03-02,1084,Organization 70,2054,Shelter Group 21,116,141,-25,1.2155172413793103
474,2023-04-18,1088,Organization 51,2007,Shelter Group 5,159,158,1,0.9937106918238994
475,2023-10-19,1037,Organization 56,2092,Shelter Group 24,85,75,10,0.8823529411764706
476,2023-01-23,1093,Organization 86,2016,Shelter Group 18,170,83,87,0.48823529411764705
477,2023-04-25,1010,Organization 44,2005,Shelter Group 10,118,116,2,0.9830508474576272
478,2023-03-29,1049,Organization 44,2024,Shelter Group 8,194,62,132,0.31958762886597936
479,2023-05-12,1052,Organization 58,2056,Shelter Group 32,59,95,-36,1.6101694915254237
480,2023-07-05,1071,Organization 34,2042,Shelter Group 9,181,138,43,0.7624309392265194
481,2023-09-08,1022,Organization 70,2033,Shelter Group 5,107,125,-18,1.1682242990654206
482,2023-07-22,1044,Organization 74,2036,Shelter Group 40,81,171,-90,2.111111111111111
483,2023-09-03,1096,Organization 7,2027,Shelter Group 26,171,124,47,0.7251461988304093
484,2023-09-03,1011,Organization 17,2063,Shelter Group 48,118,139,-21,1.1779661016949152
485,2023-06-27,1018,Organization 40,2020,Shelter Group 1,148,139,9,0.9391891891891891
486,2023-09-08,1012,Organization 53,2009,Shelter Group 50,187,83,104,0.44385026737967914
487,2023-02-17,1071,Organization 37,2069,Shelter Group 44,182,172,10,0.945054945054945
488,2023-05-11,1003,Organization 79,2007,Shelter Group 42,50,7,43,0.14
489,2023-02-02,1059,Organization 81,2053,Shelter Group 16,96,116,-20,1.2083333333333333
490,2023-06-11,1046,Organization 15,2033,Shelter Group 32,195,27,168,0.13846153846153847
491,2023-11-18,1082,Organization 45,2052,Shelter Group 1,123,67,56,0.5447154471544715
492,2023-03-05,1063,Organization 49,2002,Shelter Group 13,130,197,-67,1.5153846153846153
493,2023-06-17,1049,Organization 81,2001,Shelter Group 19,139,15,124,0.1079136690647482
494,2023-10-03,1070,Organization 21,2031,Shelter Group 19,56,117,-61,2.0892857142857144
495,2023-03-19,1030,Organization 30,2042,Shelter Group 28,161,79,82,0.4906832298136646
496,2023-06-02,1070,Organization 36,2004,Shelter Group 26,63,172,-109,2.7301587301587302
497,2023-07-18,1036,Organization 54,2036,Shelter Group 22,70,194,-124,2.7714285714285714
498,2023-04-05,1053,Organization 66,2064,Shelter Group 34,126,16,110,0.12698412698412698
499,2023-12-08,1029,Organization 12,2034,Shelter Group 45,160,64,96,0.4
500,2023-08-09,1037,Organization 27,2016,Shelter Group 12,144,174,-30,1.2083333333333333
501,2023-07-03,1061,Organization 67,2060,Shelter Group 45,114,38,76,0.3333333333333333
502,2023-06-10,1042,Organization 19,2016,Shelter Group 44,107,20,87,0.18691588785046728
503,2023-04-18,1054,Organization 34,2040,Shelter Group 26,188,165,23,0.8776595744680851
504,2023-08-30,1042,Organization 24,2099,Shelter Group 40,134,144,-10,1.0746268656716418
505,2023-06-30,1055,Organization 36,2084,Shelter Group 45,140,114,26,0.8142857142857143
506,2023-10-29,1062,Organization 27,2043,Shelter Group 25,150,170,-20,1.1333333333333333
507,2023-01-24,1046,Organization 78,2017,Shelter Group 29,180,57,123,0.31666666666666665
508,2023-11-12,1029,Organization 40,2016,Shelter Group 18,189,80,109,0.42328042328042326
509,2023-08-17,1051,Organization 49,2034,Shelter Group 15,197,49,148,0.24873096446700507
510,2023-08-12,1032,Organization 85,2008,Shelter Group 3,108,181,-73,1.6759259259259258
511,2023-09-30,1001,Organization 62,2069,Shelter Group 8,169,123,46,0.727810650887574
512,2023-07-06,1034,Organization 22,2012,Shelter Group 37,111,89,22,0.8018018018018018
513,2023-06-20,1079,Organization 98,2059,Shelter Group 44,85,94,-9,1.1058823529411765
514,2023-01-23,1010,Organization 87,2095,Shelter Group 4,185,84,101,0.4540540540540541
515,2023-08-06,1069,Organization 24,2023,Shelter Group 7,191,113,78,0.5916230366492147
516,2023-10-28,1005,Organization 37,2066,Shelter Group 40,111,68,43,0.6126126126126126
517,2023-05-16,1055,Organization 99,2015,Shelter Group 42,76,133,-57,1.75
518,2023-03-20,1081,Organization 36,2037,Shelter Group 32,171,188,-17,1.0994152046783625
519,2023-06-13,1002,Organization 45,2041,Shelter Group 3,175,138,37,0.7885714285714286
520,2023-08-25,1027,Organization 59,2079,Shelter Group 11,104,43,61,0.41346153846153844
521,2023-03-08,1062,Organization 48,2088,Shelter Group 9,81,169,-88,2.0864197530864197
522,2023-10-22,1011,Organization 77,2073,Shelter Group 3,73,82,-9,1.1232876712328768
523,2023-08-06,1064,Organization 4,2075,Shelter Group 50,152,13,139,0.08552631578947369
524,2023-10-11,1081,Organization 63,2074,Shelter Group 6,199,2,197,0.010050251256281407
525,2023-07-28,1063,Organization 16,2049,Shelter Group 17,87,16,71,0.1839080459770115
526,2023-03-28,1099,Organization 62,2039,Shelter Group 47,134,164,-30,1.2238805970149254
527,2023-06-30,1042,Organization 23,2028,Shelter Group 48,132,118,14,0.8939393939393939
528,2023-12-24,1013,Organization 32,2017,Shelter Group 2,72,138,-66,1.9166666666666667
529,2023-05-18,1064,Organization 23,2037,Shelter Group 11,192,46,146,0.23958333333333334
530,2023-12-31,1057,Organization 69,2035,Shelter Group 49,58,112,-54,1.9310344827586208
531,2023-12-24,1094,Organization 76,2082,Shelter Group 48,100,61,39,0.61
532,2023-02-10,1031,Organization 97,2078,Shelter Group 35,144,192,-48,1.3333333333333333
533,2023-05-09,1051,Organization 54,2061,Shelter Group 39,154,11,143,0.07142857142857142
534,2023-12-02,1098,Organization 83,2071,Shelter Group 47,141,142,-1,1.0070921985815602
535,2023-08-20,1017,Organization 58,2045,Shelter Group 34,128,80,48,0.625
536,2023-11-30,1073,Organization 16,2031,Shelter Group 48,53,6,47,0.11320754716981132
537,2023-08-06,1050,Organization 44,2003,Shelter Group 34,153,27,126,0.17647058823529413
538,2023-11-24,1073,Organization 10,2034,Shelter Group 44,88,88,0,1
539,2023-05-07,1062,Organization 59,2025,Shelter Group 34,123,135,-12,1.0975609756097562
540,2023-02-10,1059,Organization 8,2075,Shelter Group 28,189,41,148,0.21693121693121692
541,2023-09-21,1058,Organization 63,2080,Shelter Group 9,156,10,146,0.0641025641025641
542,2023-07-04,1086,Organization 20,2057,Shelter Group 46,188,49,139,0.26063829787234044
543,2023-07-20,1047,Organization 18,2099,Shelter Group 37,58,123,-65,2.1206896551724137
544,2023-02-21,1032,Organization 38,2036,Shelter Group 6,77,67,10,0.8701298701298701
545,2023-08-13,1066,Organization 31,2007,Shelter Group 4,196,97,99,0.49489795918367346
546,2023-03-08,1001,Organization 34,2010,Shelter Group 15,196,24,172,0.12244897959183673
547,2023-06-17,1018,Organization 49,2020,Shelter Group 31,51,71,-20,1.392156862745098
548,2023-09-15,1071,Organization 59,2062,Shelter Group 10,96,87,9,0.90625
549,2023-03-06,1091,Organization 91,2017,Shelter Group 19,167,198,-31,1.18562874251497
550,2023-01-29,1071,Organization 76,2085,Shelter Group 8,104,32,72,0.3076923076923077
551,2023-01-20,1036,Organization 77,2078,Shelter Group 47,141,34,107,0.24113475177304963
552,2023-07-25,1069,Organization 28,2003,Shelter Group 3,162,7,155,0.043209876543209874
553,2023-05-04,1075,Organization 50,2052,Shelter Group 7,91,66,25,0.7252747252747253
554,2023-03-21,1027,Organization 28,2078,Shelter Group 41,169,85,84,0.5029585798816568
555,2023-09-20,1095,Organization 44,2096,Shelter Group 3,159,30,129,0.18867924528301888
556,2023-08-16,1042,Organization 7,2030,Shelter Group 4,104,54,50,0.5192307692307693
557,2023-02-14,1075,Organization 93,2035,Shelter Group 13,188,51,137,0.2712765957446808
558,2023-11-28,1028,Organization 74,2078,Shelter Group 39,96,51,45,0.53125
559,2023-10-08,1033,Organization 72,2017,Shelter Group 12,199,3,196,0.01507537688442211
560,2023-04-01,1032,Organization 76,2011,Shelter Group 7,128,63,65,0.4921875
561,2023-05-21,1087,Organization 46,2001,Shelter Group 13,98,160,-62,1.6326530612244898
562,2023-05-18,1085,Organization 32,2073,Shelter Group 7,171,36,135,0.21052631578947367
563,2023-04-04,1044,Organization 85,2059,Shelter Group 48,75,13,62,0.17333333333333334
564,2023-05-07,1062,Organization 95,2091,Shelter Group 6,148,119,29,0.8040540540540541
565,2023-09-25,1037,Organization 58,2067,Shelter Group 8,113,64,49,0.5663716814159292
566,2023-01-08,1096,Organization 19,2052,Shelter Group 30,138,34,104,0.2463768115942029
567,2023-11-23,1040,Organization 88,2044,Shelter Group 32,156,92,64,0.5897435897435898
568,2023-09-28,1079,Organization 73,2022,Shelter Group 36,120,148,-28,1.2333333333333334
569,2023-03-24,1096,Organization 8,2044,Shelter Group 4,144,177,-33,1.2291666666666667
570,2023-08-23,1071,Organization 98,2048,Shelter Group 41,159,148,11,0.9308176100628931
571,2023-06-16,1014,Organization 90,2041,Shelter Group 50,138,187,-49,1.355072463768116
572,2023-09-12,1056,Organization 93,2094,Shelter Group 14,67,145,-78,2.1641791044776117
573,2023-03-28,1048,Organization 41,2073,Shelter Group 34,163,36,127,0.22085889570552147
574,2023-05-02,1089,Organization 42,2015,Shelter Group 47,196,7,189,0.03571428571428571
575,2023-03-12,1003,Organization 39,2046,Shelter Group 7,76,28,48,0.3684210526315789
576,2023-09-17,1023,Organization 23,2035,Shelter Group 12,125,102,23,0.816
577,2023-03-22,1075,Organization 27,2008,Shelter Group 3,139,193,-54,1.3884892086330936
578,2023-09-21,1061,Organization 4,2048,Shelter Group 28,120,36,84,0.3
579,2023-03-08,1095,Organization 34,2065,Shelter Group 33,78,141,-63,1.8076923076923077
580,2023-12-30,1062,Organization 26,2090,Shelter Group 27,199,75,124,0.3768844221105528
581,2023-08-26,1067,Organization 47,2001,Shelter Group 31,120,3,117,0.025
582,2023-09-27,1008,Organization 64,2029,Shelter Group 44,94,7,87,0.07446808510638298
583,2023-05-14,1060,Organization 65,2062,Shelter Group 41,166,156,10,0.9397590361445783
584,2023-05-17,1091,Organization 71,2022,Shelter Group 36,134,47,87,0.35074626865671643
585,2023-06-10,1091,Organization 17,2023,Shelter Group 41,188,166,22,0.8829787234042553
586,2023-04-26,1049,Organization 95,2031,Shelter Group 1,78,59,19,0.7564102564102564
587,2023-02-15,1089,Organization 43,2011,Shelter Group 50,70,11,59,0.15714285714285714
588,2023-03-05,1028,Organization 36,2094,Shelter Group 49,148,143,5,0.9662162162162162
589,2023-01-19,1028,Organization 100,2037,Shelter Group 9,72,133,-61,1.8472222222222223
590,2023-08-17,1077,Organization 38,2095,Shelter Group 35,104,116,-12,1.1153846153846154
591,2023-04-08,1079,Organization 84,2094,Shelter Group 39,69,96,-27,1.391304347826087
592,2023-05-09,1044,Organization 60,2024,Shelter Group 24,99,132,-33,1.3333333333333333
593,2023-08-08,1051,Organization 17,2026,Shelter Group 44,175,151,24,0.8628571428571429
594,2023-06-29,1051,Organization 64,2090,Shelter Group 36,145,73,72,0.503448275862069
595,2023-08-10,1031,Organization 59,2040,Shelter Group 16,56,87,-31,1.5535714285714286
596,2023-11-20,1077,Organization 26,2003,Shelter Group 50,174,18,156,0.10344827586206896
597,2023-03-31,1041,Organization 81,2020,Shelter Group 13,161,108,53,0.6708074534161491
598,2023-05-02,1075,Organization 32,2085,Shelter Group 38,126,198,-72,1.5714285714285714
599,2023-11-27,1057,Organization 90,2014,Shelter Group 17,78,27,51,0.34615384615384615
600,2023-10-02,1046,Organization 71,2016,Shelter Group 22,128,6,122,0.046875
601,2023-10-18,1051,Organization 69,2091,Shelter Group 35,171,60,111,0.3508771929824561
602,2023-08-19,1060,Organization 29,2080,Shelter Group 47,120,105,15,0.875
603,2023-07-16,1062,Organization 88,2099,Shelter Group 43,112,52,60,0.4642857142857143
604,2023-11-13,1055,Organization 21,2014,Shelter Group 4,184,48,136,0.2608695652173913
605,2023-06-18,1022,Organization 48,2090,Shelter Group 45,115,49,66,0.4260869565217391
606,2023-08-05,1024,Organization 85,2081,Shelter Group 3,150,182,-32,1.2133333333333334
607,2023-02-18,1012,Organization 37,2063,Shelter Group 37,169,160,9,0.9467455621301775
608,2023-12-07,1044,Organization 11,2031,Shelter Group 35,73,114,-41,1.5616438356164384
609,2023-03-10,1090,Organization 58,2017,Shelter Group 3,135,19,116,0.14074074074074075
610,2023-11-16,1020,Organization 96,2084,Shelter Group 46,70,0,70,0
611,2023-03-17,1100,Organization 87,2066,Shelter Group 12,163,185,-22,1.1349693251533743
612,2023-01-02,1061,Organization 11,2016,Shelter Group 17,174,71,103,0.40804597701149425
613,2023-10-01,1092,Organization 87,2014,Shelter Group 32,165,15,150,0.09090909090909091
614,2023-09-17,1080,Organization 100,2037,Shelter Group 36,141,18,123,0.1276595744680851
615,2023-04-16,1049,Organization 22,2096,Shelter Group 22,166,61,105,0.3674698795180723
616,2023-04-21,1044,Organization 92,2041,Shelter Group 11,183,159,24,0.8688524590163934
617,2023-12-09,1066,Organization 17,2024,Shelter Group 21,193,25,168,0.12953367875647667
618,2023-03-13,1037,Organization 79,2029,Shelter Group 10,185,132,53,0.7135135135135136
619,2023-08-17,1019,Organization 34,2021,Shelter Group 7,67,50,17,0.746268656716418
620,2023-01-11,1077,Organization 97,2091,Shelter Group 34,128,81,47,0.6328125
621,2023-07-26,1094,Organization 73,2093,Shelter Group 13,72,161,-89,2.236111111111111
622,2023-12-01,1056,Organization 35,2091,Shelter Group 26,192,161,31,0.8385416666666666
623,2023-02-25,1005,Organization 4,2028,Shelter Group 1,154,145,9,0.9415584415584416
624,2023-04-16,1071,Organization 41,2010,Shelter Group 42,181,154,27,0.850828729281768
625,2023-09-28,1016,Organization 75,2093,Shelter Group 21,101,110,-9,1.0891089108910892
626,2023-07-26,1083,Organization 83,2052,Shelter Group 44,160,30,130,0.1875
627,2023-12-30,1056,Organization 41,2018,Shelter Group 13,95,42,53,0.4421052631578947
628,2023-03-30,1026,Organization 42,2098,Shelter Group 46,123,164,-41,1.3333333333333333
629,2023-10-19,1045,Organization 16,2004,Shelter Group 43,120,2,118,0.016666666666666666
630,2023-09-20,1038,Organization 13,2041,Shelter Group 15,53,52,1,0.9811320754716981
631,2023-03-09,1010,Organization 24,2047,Shelter Group 18,187,198,-11,1.0588235294117647
632,2023-04-30,1040,Organization 86,2066,Shelter Group 41,136,127,9,0.9338235294117647
633,2023-08-20,1010,Organization 77,2068,Shelter Group 24,63,21,42,0.3333333333333333
634,2023-02-22,1038,Organization 47,2012,Shelter Group 16,102,24,78,0.23529411764705882
635,2023-12-23,1091,Organization 4,2029,Shelter Group 26,61,167,-106,2.737704918032787
636,2023-10-07,1051,Organization 72,2050,Shelter Group 26,136,50,86,0.36764705882352944
637,2023-08-18,1029,Organization 10,2075,Shelter Group 20,168,184,-16,1.0952380952380953
638,2023-11-20,1094,Organization 37,2091,Shelter Group 13,102,16,86,0.1568627450980392
639,2023-11-19,1087,Organization 18,2030,Shelter Group 8,104,50,54,0.4807692307692308
640,2023-01-11,1054,Organization 78,2068,Shelter Group 9,114,6,108,0.05263157894736842
641,2023-03-15,1085,Organization 22,2010,Shelter Group 41,85,119,-34,1.4
642,2023-09-13,1066,Organization 93,2087,Shelter Group 7,93,89,4,0.956989247311828
643,2023-12-15,1087,Organization 19,2044,Shelter Group 34,194,78,116,0.4020618556701031
644,2023-03-29,1064,Organization 83,2066,Shelter Group 38,176,50,126,0.2840909090909091
645,2023-12-11,1019,Organization 50,2032,Shelter Group 1,70,173,-103,2.4714285714285715
646,2023-01-11,1019,Organization 38,2050,Shelter Group 44,92,76,16,0.8260869565217391
647,2023-03-15,1077,Organization 40,2044,Shelter Group 37,130,195,-65,1.5
648,2023-08-31,1033,Organization 7,2006,Shelter Group 8,132,89,43,0.6742424242424242
649,2023-07-07,1038,Organization 95,2081,Shelter Group 24,193,186,7,0.9637305699481865
650,2023-10-14,1064,Organization 36,2024,Shelter Group 20,88,192,-104,2.1818181818181817
651,2023-11-26,1037,Organization 12,2039,Shelter Group 49,99,165,-66,1.6666666666666667
652,2023-06-22,1071,Organization 10,2078,Shelter Group 9,122,51,71,0.4180327868852459
653,2023-11-11,1026,Organization 60,2075,Shelter Group 1,197,33,164,0.16751269035532995
654,2023-10-07,1081,Organization 10,2090,Shelter Group 34,83,40,43,0.4819277108433735
655,2023-10-18,1047,Organization 79,2088,Shelter Group 2,172,102,70,0.5930232558139535
656,2023-08-30,1037,Organization 74,2042,Shelter Group 28,118,152,-34,1.2881355932203389
657,2023-09-23,1032,Organization 93,2083,Shelter Group 10,68,153,-85,2.25
658,2023-03-05,1045,Organization 75,2047,Shelter Group 30,63,154,-91,2.4444444444444446
659,2023-11-24,1040,Organization 44,2078,Shelter Group 1,136,121,15,0.8897058823529411
660,2023-06-21,1097,Organization 61,2010,Shelter Group 16,136,48,88,0.35294117647058826
661,2023-10-25,1036,Organization 54,2047,Shelter Group 21,172,8,164,0.046511627906976744
662,2023-06-09,1056,Organization 66,2033,Shelter Group 8,102,113,-11,1.107843137254902
663,2023-06-16,1050,Organization 33,2023,Shelter Group 8,120,180,-60,1.5
664,2023-06-15,1068,Organization 21,2031,Shelter Group 34,88,189,-101,2.147727272727273
665,2023-01-17,1040,Organization 19,2022,Shelter Group 32,72,52,20,0.7222222222222222
666,2023-08-17,1028,Organization 79,2087,Shelter Group 7,103,125,-22,1.2135922330097086
667,2023-12-31,1056,Organization 45,2029,Shelter Group 47,145,157,-12,1.0827586206896551
668,2023-03-20,1085,Organization 6,2030,Shelter Group 39,181,31,150,0.1712707182320442
669,2023-08-15,1054,Organization 67,2081,Shelter Group 16,104,188,-84,1.8076923076923077
670,2023-11-18,1055,Organization 90,2057,Shelter Group 12,102,36,66,0.35294117647058826
671,2023-11-22,1087,Organization 36,2073,Shelter Group 11,115,142,-27,1.2347826086956522
672,2023-04-20,1036,Organization 74,2004,Shelter Group 1,138,126,12,0.9130434782608695
673,2023-11-11,1082,Organization 67,2071,Shelter Group 1,79,71,8,0.8987341772151899
674,2023-08-31,1046,Organization 4,2002,Shelter Group 13,109,182,-73,1.6697247706422018
675,2023-09-22,1028,Organization 38,2026,Shelter Group 30,144,76,68,0.5277777777777778
676,2023-01-23,1095,Organization 79,2084,Shelter Group 1,101,159,-58,1.5742574257425743
677,2023-10-08,1012,Organization 39,2016,Shelter Group 5,143,186,-43,1.3006993006993006
678,2023-04-22,1011,Organization 66,2045,Shelter Group 34,195,131,64,0.6717948717948717
679,2023-04-03,1088,Organization 88,2052,Shelter Group 20,98,96,2,0.9795918367346939
680,2023-10-04,1030,Organization 13,2096,Shelter Group 1,186,132,54,0.7096774193548387
681,2023-04-29,1011,Organization 63,2039,Shelter Group 49,120,103,17,0.8583333333333333
682,2023-02-17,1088,Organization 95,2034,Shelter Group 4,200,51,149,0.255
683,2023-09-05,1017,Organization 24,2054,Shelter Group 22,194,50,144,0.25773195876288657
684,2023-04-15,1023,Organization 70,2077,Shelter Group 4,61,17,44,0.2786885245901639
685,2023-06-20,1098,Organization 66,2039,Shelter Group 22,104,78,26,0.75
686,2023-07-03,1074,Organization 30,2036,Shelter Group 46,104,38,66,0.36538461538461536
687,2023-01-04,1054,Organization 12,2035,Shelter Group 25,106,14,92,0.1320754716981132
688,2023-11-23,1004,Organization 90,2049,Shelter Group 20,86,128,-42,1.4883720930232558
689,2023-11-08,1070,Organization 41,2045,Shelter Group 36,70,197,-127,2.8142857142857145
690,2023-02-19,1074,Organization 59,2088,Shelter Group 10,162,115,47,0.7098765432098766
691,2023-05-19,1083,Organization 44,2068,Shelter Group 50,99,73,26,0.7373737373737373
692,2023-09-03,1041,Organization 2,2064,Shelter Group 46,109,18,91,0.1651376146788991
693,2023-11-27,1092,Organization 60,2091,Shelter Group 1,73,11,62,0.1506849315068493
694,2023-11-12,1048,Organization 43,2080,Shelter Group 26,53,25,28,0.4716981132075472
695,2023-09-07,1073,Organization 41,2072,Shelter Group 24,91,21,70,0.23076923076923078
696,2023-08-18,1007,Organization 56,2067,Shelter Group 21,169,147,22,0.8698224852071006
697,2023-03-26,1051,Organization 76,2081,Shelter Group 36,189,51,138,0.2698412698412698
698,2023-11-26,1024,Organization 65,2021,Shelter Group 40,89,20,69,0.2247191011235955
699,2023-05-01,1082,Organization 27,2030,Shelter Group 26,107,123,-16,1.1495327102803738
700,2023-04-24,1088,Organization 34,2045,Shelter Group 16,174,14,160,0.08045977011494253
701,2023-07-14,1072,Organization 50,2074,Shelter Group 50,135,50,85,0.37037037037037035
702,2023-04-09,1064,Organization 39,2037,Shelter Group 2,70,23,47,0.32857142857142857
703,2023-04-08,1060,Organization 28,2059,Shelter Group 32,101,158,-57,1.5643564356435644
704,2023-02-27,1016,Organization 69,2098,Shelter Group 30,125,195,-70,1.56
705,2023-01-13,1047,Organization 47,2074,Shelter Group 26,72,184,-112,2.5555555555555554
706,2023-01-08,1082,Organization 29,2004,Shelter Group 14,192,91,101,0.4739583333333333
707,2023-09-15,1029,Organization 54,2088,Shelter Group 33,80,15,65,0.1875
708,2023-05-03,1061,Organization 21,2020,Shelter Group 8,194,12,182,0.061855670103092786
709,2023-09-19,1062,Organization 69,2043,Shelter Group 31,79,48,31,0.6075949367088608
710,2023-03-28,1025,Organization 12,2002,Shelter Group 36,122,171,-49,1.401639344262295
711,2023-01-17,1080,Organization 36,2046,Shelter Group 14,129,143,-14,1.1085271317829457
712,2023-07-25,1069,Organization 93,2100,Shelter Group 43,140,60,80,0.42857142857142855
713,2023-07-18,1023,Organization 68,2097,Shelter Group 45,141,122,19,0.8652482269503546
714,2023-03-18,1067,Organization 25,2014,Shelter Group 29,139,51,88,0.3669064748201439
715,2023-11-24,1070,Organization 1,2087,Shelter Group 18,177,41,136,0.23163841807909605
716,2023-12-24,1089,Organization 26,2006,Shelter Group 33,170,145,25,0.8529411764705882
717,2023-08-22,1019,Organization 52,2053,Shelter Group 24,173,114,59,0.6589595375722543
718,2023-01-17,1011,Organization 64,2087,Shelter Group 46,123,29,94,0.23577235772357724
719,2023-11-23,1012,Organization 80,2050,Shelter Group 31,167,105,62,0.6287425149700598
720,2023-02-24,1097,Organization 79,2063,Shelter Group 49,107,198,-91,1.8504672897196262
721,2023-01-19,1062,Organization 14,2066,Shelter Group 5,88,61,27,0.6931818181818182
722,2023-08-29,1072,Organization 74,2036,Shelter Group 23,93,58,35,0.6236559139784946
723,2023-09-28,1071,Organization 92,2032,Shelter Group 34,196,186,10,0.9489795918367347
724,2023-08-06,1079,Organization 48,2081,Shelter Group 22,116,74,42,0.6379310344827587
725,2023-06-04,1099,Organization 14,2091,Shelter Group 24,93,182,-89,1.956989247311828
726,2023-07-28,1007,Organization 61,2085,Shelter Group 44,51,114,-63,2.235294117647059
727,2023-02-02,1013,Organization 77,2023,Shelter Group 26,95,31,64,0.3263157894736842
728,2023-11-02,1084,Organization 8,2080,Shelter Group 19,56,47,9,0.8392857142857143
729,2023-10-01,1073,Organization 91,2061,Shelter Group 21,158,102,56,0.6455696202531646
730,2023-05-28,1012,Organization 18,2008,Shelter Group 25,196,28,168,0.14285714285714285
731,2023-12-13,1078,Organization 15,2066,Shelter Group 40,146,169,-23,1.1575342465753424
732,2023-10-25,1092,Organization 55,2081,Shelter Group 38,54,129,-75,2.388888888888889
733,2023-03-15,1073,Organization 34,2035,Shelter Group 23,51,28,23,0.5490196078431373
734,2023-02-22,1096,Organization 85,2002,Shelter Group 46,107,45,62,0.4205607476635514
735,2023-11-15,1036,Organization 25,2033,Shelter Group 33,88,32,56,0.36363636363636365
736,2023-11-25,1083,Organization 58,2010,Shelter Group 17,135,172,-37,1.2740740740740741
737,2023-06-08,1034,Organization 75,2083,Shelter Group 42,101,2,99,0.019801980198019802
738,2023-12-05,1061,Organization 1,2030,Shelter Group 41,172,15,157,0.0872093023255814
739,2023-02-24,1056,Organization 54,2058,Shelter Group 8,112,200,-88,1.7857142857142858
740,2023-09-04,1076,Organization 77,2091,Shelter Group 42,181,63,118,0.34806629834254144
741,2023-01-18,1014,Organization 40,2097,Shelter Group 19,113,82,31,0.7256637168141593
742,2023-12-30,1074,Organization 72,2063,Shelter Group 2,83,125,-42,1.5060240963855422
743,2023-02-13,1016,Organization 18,2018,Shelter Group 39,117,114,3,0.9743589743589743
744,2023-12-14,1098,Organization 39,2004,Shelter Group 6,121,51,70,0.4214876033057851
745,2023-01-21,1074,Organization 88,2062,Shelter Group 34,180,71,109,0.39444444444444443
746,2023-01-29,1066,Organization 45,2023,Shelter Group 39,88,99,-11,1.125
747,2023-03-25,1021,Organization 79,2002,Shelter Group 1,89,95,-6,1.0674157303370786
748,2023-01-23,1008,Organization 90,2042,Shelter Group 28,181,146,35,0.8066298342541437
749,2023-02-11,1033,Organization 80,2032,Shelter Group 10,135,182,-47,1.348148148148148
750,2023-07-16,1097,Organization 24,2096,Shelter Group 48,102,70,32,0.6862745098039216
751,2023-07-13,1079,Organization 44,2001,Shelter Group 40,137,160,-23,1.167883211678832
752,2023-03-23,1088,Organization 96,2096,Shelter Group 38,188,43,145,0.22872340425531915
753,2023-11-14,1018,Organization 80,2061,Shelter Group 10,156,94,62,0.6025641025641025
754,2023-03-05,1099,Organization 43,2065,Shelter Group 43,149,22,127,0.1476510067114094
755,2023-03-18,1016,Organization 69,2083,Shelter Group 32,50,26,24,0.52
756,2023-04-17,1004,Organization 4,2040,Shelter Group 15,176,175,1,0.9943181818181818
757,2023-06-28,1039,Organization 26,2092,Shelter Group 50,67,146,-79,2.1791044776119404
758,2023-05-26,1098,Organization 57,2030,Shelter Group 13,57,167,-110,2.9298245614035086
759,2023-09-23,1062,Organization 78,2087,Shelter Group 42,97,123,-26,1.268041237113402
760,2023-07-20,1092,Organization 72,2033,Shelter Group 19,149,193,-44,1.2953020134228188
761,2023-12-21,1036,Organization 86,2074,Shelter Group 31,171,10,161,0.05847953216374269
762,2023-12-05,1083,Organization 79,2048,Shelter Group 2,83,8,75,0.0963855421686747
763,2023-07-19,1023,Organization 30,2071,Shelter Group 35,195,32,163,0.1641025641025641
764,2023-08-25,1072,Organization 43,2023,Shelter Group 23,175,62,113,0.35428571428571426
765,2023-09-15,1019,Organization 56,2086,Shelter Group 17,145,164,-19,1.1310344827586207
766,2023-09-11,1071,Organization 95,2046,Shelter Group 9,166,121,45,0.7289156626506024
767,2023-04-22,1076,Organization 52,2057,Shelter Group 4,171,100,71,0.5847953216374269
768,2023-01-05,1066,Organization 74,2063,Shelter Group 32,142,9,133,0.06338028169014084
769,2023-04-10,1018,Organization 83,2074,Shelter Group 37,194,52,142,0.26804123711340205
770,2023-05-23,1057,Organization 96,2030,Shelter Group 18,151,158,-7,1.0463576158940397
771,2023-08-22,1048,Organization 5,2085,Shelter Group 29,64,69,-5,1.078125
772,2023-04-13,1023,Organization 1,2100,Shelter Group 14,177,25,152,0.14124293785310735
773,2023-02-27,1011,Organization 76,2075,Shelter Group 12,70,163,-93,2.3285714285714287
774,2023-10-17,1002,Organization 18,2044,Shelter Group 18,72,151,-79,2.0972222222222223
775,2023-10-14,1046,Organization 6,2012,Shelter Group 50,110,114,-4,1.0363636363636364
776,2023-01-18,1089,Organization 64,2070,Shelter Group 1,193,45,148,0.23316062176165803
777,2023-10-29,1089,Organization 79,2069,Shelter Group 44,84,83,1,0.9880952380952381
778,2023-09-22,1017,Organization 95,2055,Shelter Group 47,100,86,14,0.86
779,2023-03-20,1022,Organization 50,2016,Shelter Group 41,90,68,22,0.7555555555555555
780,2023-05-15,1077,Organization 88,2047,Shelter Group 39,160,84,76,0.525
781,2023-11-17,1086,Organization 42,2058,Shelter Group 49,176,133,43,0.7556818181818182
782,2023-01-09,1025,Organization 33,2051,Shelter Group 7,87,122,-35,1.4022988505747127
783,2023-12-21,1055,Organization 94,2009,Shelter Group 48,122,86,36,0.7049180327868853
784,2023-10-08,1073,Organization 29,2028,Shelter Group 33,167,138,29,0.8263473053892215
785,2023-05-10,1060,Organization 62,2065,Shelter Group 49,196,23,173,0.11734693877551021
786,2023-07-15,1035,Organization 6,2050,Shelter Group 50,168,177,-9,1.0535714285714286
787,2023-02-09,1088,Organization 59,2042,Shelter Group 13,143,153,-10,1.06993006993007
788,2023-05-28,1042,Organization 21,2017,Shelter Group 18,94,78,16,0.8297872340425532
789,2023-05-19,1076,Organization 25,2090,Shelter Group 6,141,95,46,0.6737588652482269
790,2023-01-18,1015,Organization 96,2084,Shelter Group 37,161,134,27,0.8322981366459627
791,2023-12-14,1015,Organization 15,2050,Shelter Group 21,109,0,109,0
792,2023-03-08,1036,Organization 72,2038,Shelter Group 18,59,175,-116,2.9661016949152543
793,2023-08-08,1025,Organization 22,2057,Shelter Group 21,101,175,-74,1.7326732673267327
794,2023-04-03,1041,Organization 86,2075,Shelter Group 8,137,93,44,0.6788321167883211
795,2023-02-08,1005,Organization 37,2075,Shelter Group 27,197,57,140,0.2893401015228426
796,2023-05-31,1078,Organization 60,2020,Shelter Group 46,100,124,-24,1.24
797,2023-03-20,1081,Organization 50,2039,Shelter Group 37,65,139,-74,2.1384615384615384
798,2023-12-10,1002,Organization 8,2078,Shelter Group 14,83,67,16,0.8072289156626506
799,2023-06-17,1051,Organization 84,2022,Shelter Group 47,103,110,-7,1.0679611650485437
800,2023-06-10,1088,Organization 36,2088,Shelter Group 20,69,6,63,0.08695652173913043
801,2023-01-29,1075,Organization 41,2022,Shelter Group 28,118,55,63,0.4661016949152542
802,2023-05-01,1033,Organization 75,2057,Shelter Group 26,97,122,-25,1.2577319587628866
803,2023-08-29,1007,Organization 56,2070,Shelter Group 25,61,21,40,0.3442622950819672
804,2023-06-02,1015,Organization 31,2089,Shelter Group 14,104,146,-42,1.4038461538461537
805,2023-02-11,1090,Organization 80,2024,Shelter Group 18,79,166,-87,2.1012658227848102
806,2023-02-13,1087,Organization 10,2051,Shelter Group 38,96,17,79,0.17708333333333334
807,2023-08-12,1011,Organization 100,2026,Shelter Group 44,50,73,-23,1.46
808,2023-01-08,1048,Organization 33,2002,Shelter Group 22,189,105,84,0.5555555555555556
809,2023-02-08,1025,Organization 11,2020,Shelter Group 1,121,94,27,0.7768595041322314
810,2023-12-18,1010,Organization 66,2013,Shelter Group 13,123,130,-7,1.056910569105691
811,2023-11-17,1098,Organization 8,2076,Shelter Group 39,170,16,154,0.09411764705882353
812,2023-12-16,1028,Organization 23,2047,Shelter Group 35,184,13,171,0.07065217391304347
813,2023-11-10,1006,Organization 42,2098,Shelter Group 1,187,18,169,0.0962566844919786
814,2023-08-05,1012,Organization 29,2087,Shelter Group 14,143,111,32,0.7762237762237763
815,2023-07-03,1019,Organization 95,2061,Shelter Group 46,54,172,-118,3.185185185185185
816,2023-06-20,1035,Organization 52,2060,Shelter Group 18,138,55,83,0.39855072463768115
817,2023-02-25,1008,Organization 85,2086,Shelter Group 48,56,8,48,0.14285714285714285
818,2023-10-05,1055,Organization 51,2006,Shelter Group 1,157,150,7,0.9554140127388535
819,2023-04-09,1092,Organization 4,2080,Shelter Group 4,117,16,101,0.13675213675213677
820,2023-05-22,1048,Organization 45,2089,Shelter Group 11,150,96,54,0.64
821,2023-08-17,1002,Organization 15,2090,Shelter Group 13,129,16,113,0.12403100775193798
822,2023-03-05,1077,Organization 35,2079,Shelter Group 34,90,60,30,0.6666666666666666
823,2023-08-30,1053,Organization 50,2041,Shelter Group 31,102,67,35,0.6568627450980392
824,2023-10-07,1083,Organization 32,2051,Shelter Group 8,176,22,154,0.125
825,2023-08-10,1031,Organization 68,2098,Shelter Group 48,117,129,-12,1.1025641025641026
826,2023-01-08,1075,Organization 82,2079,Shelter Group 31,94,160,-66,1.702127659574468
827,2023-05-28,1075,Organization 17,2062,Shelter Group 20,65,116,-51,1.7846153846153847
828,2023-03-15,1029,Organization 74,2008,Shelter Group 5,94,143,-49,1.5212765957446808
829,2023-03-27,1033,Organization 84,2005,Shelter Group 44,148,181,-33,1.222972972972973
830,2023-01-17,1027,Organization 63,2053,Shelter Group 6,55,55,0,1
831,2023-05-17,1025,Organization 16,2018,Shelter Group 37,66,96,-30,1.4545454545454546
832,2023-06-12,1072,Organization 31,2094,Shelter Group 4,167,87,80,0.5209580838323353
833,2023-07-04,1097,Organization 100,2081,Shelter Group 16,164,166,-2,1.0121951219512195
834,2023-05-24,1092,Organization 70,2032,Shelter Group 21,103,148,-45,1.4368932038834952
835,2023-11-04,1056,Organization 69,2020,Shelter Group 48,144,111,33,0.7708333333333334
836,2023-12-21,1040,Organization 34,2078,Shelter Group 26,200,145,55,0.725
837,2023-02-04,1063,Organization 84,2020,Shelter Group 26,79,29,50,0.3670886075949367
838,2023-01-26,1072,Organization 77,2066,Shelter Group 34,187,148,39,0.7914438502673797
839,2023-09-26,1080,Organization 22,2038,Shelter Group 15,133,16,117,0.12030075187969924
840,2023-02-05,1010,Organization 11,2061,Shelter Group 14,134,101,33,0.753731343283582
841,2023-06-24,1015,Organization 2,2092,Shelter Group 50,91,191,-100,2.098901098901099
842,2023-01-28,1042,Organization 29,2087,Shelter Group 12,99,51,48,0.5151515151515151
843,2023-06-06,1024,Organization 3,2061,Shelter Group 16,75,98,-23,1.3066666666666666
844,2023-10-27,1092,Organization 69,2029,Shelter Group 44,170,187,-17,1.1
845,2023-11-06,1040,Organization 4,2071,Shelter Group 29,137,134,3,0.9781021897810219
846,2023-06-02,1002,Organization 62,2023,Shelter Group 18,96,183,-87,1.90625
847,2023-10-12,1018,Organization 19,2007,Shelter Group 13,192,20,172,0.10416666666666667
848,2023-05-28,1075,Organization 69,2019,Shelter Group 16,118,199,-81,1.6864406779661016
849,2023-04-03,1002,Organization 18,2086,Shelter Group 47,194,92,102,0.4742268041237113
850,2023-09-26,1060,Organization 88,2095,Shelter Group 21,119,48,71,0.40336134453781514
851,2023-07-24,1019,Organization 14,2042,Shelter Group 48,78,36,42,0.46153846153846156
852,2023-06-12,1066,Organization 73,2048,Shelter Group 1,111,7,104,0.06306306306306306
853,2023-01-05,1041,Organization 94,2030,Shelter Group 38,79,91,-12,1.1518987341772151
854,2023-02-25,1087,Organization 93,2022,Shelter Group 14,181,134,47,0.7403314917127072
855,2023-03-18,1005,Organization 56,2092,Shelter Group 30,63,84,-21,1.3333333333333333
856,2023-12-14,1006,Organization 11,2061,Shelter Group 32,198,86,112,0.43434343434343436
857,2023-06-21,1081,Organization 95,2001,Shelter Group 24,163,73,90,0.44785276073619634
858,2023-03-13,1027,Organization 61,2092,Shelter Group 44,119,178,-59,1.495798319327731
859,2023-05-06,1012,Organization 35,2001,Shelter Group 43,151,42,109,0.2781456953642384
860,2023-06-01,1079,Organization 43,2052,Shelter Group 7,112,175,-63,1.5625
861,2023-07-27,1098,Organization 52,2081,Shelter Group 2,76,92,-16,1.2105263157894737
862,2023-03-16,1014,Organization 38,2001,Shelter Group 5,59,23,36,0.3898305084745763
863,2023-03-28,1002,Organization 65,2083,Shelter Group 49,100,161,-61,1.61
864,2023-04-04,1080,Organization 70,2066,Shelter Group 49,199,131,68,0.6582914572864321
865,2023-10-31,1015,Organization 26,2032,Shelter Group 28,180,6,174,0.03333333333333333
866,2023-09-28,1061,Organization 4,2065,Shelter Group 50,117,167,-50,1.4273504273504274
867,2023-11-17,1074,Organization 82,2031,Shelter Group 19,56,83,-27,1.4821428571428572
868,2023-07-01,1024,Organization 43,2009,Shelter Group 14,123,2,121,0.016260162601626018
869,2023-09-23,1091,Organization 86,2002,Shelter Group 34,177,84,93,0.4745762711864407
870,2023-03-27,1003,Organization 46,2057,Shelter Group 42,112,114,-2,1.0178571428571428
871,2023-02-11,1034,Organization 30,2062,Shelter Group 26,84,111,-27,1.3214285714285714
872,2023-04-10,1043,Organization 70,2042,Shelter Group 9,115,84,31,0.7304347826086957
873,2023-01-25,1040,Organization 68,2066,Shelter Group 30,199,155,44,0.7788944723618091
874,2023-04-04,1059,Organization 12,2026,Shelter Group 27,159,70,89,0.44025157232704404
875,2023-06-29,1030,Organization 53,2084,Shelter Group 16,86,36,50,0.4186046511627907
876,2023-10-20,1016,Organization 29,2084,Shelter Group 1,50,119,-69,2.38
877,2023-01-27,1009,Organization 42,2064,Shelter Group 13,92,50,42,0.5434782608695652
878,2023-07-20,1057,Organization 74,2059,Shelter Group 39,173,131,42,0.7572254335260116
879,2023-07-30,1064,Organization 52,2063,Shelter Group 1,170,196,-26,1.1529411764705881
880,2023-02-04,1047,Organization 7,2045,Shelter Group 12,175,63,112,0.36
881,2023-07-10,1077,Organization 71,2073,Shelter Group 17,156,63,93,0.40384615384615385
882,2023-12-09,1055,Organization 87,2076,Shelter Group 24,158,103,55,0.6518987341772152
883,2023-03-17,1091,Organization 35,2035,Shelter Group 39,173,170,3,0.9826589595375722
884,2023-07-26,1082,Organization 6,2092,Shelter Group 36,182,13,169,0.07142857142857142
885,2023-10-18,1044,Organization 41,2030,Shelter Group 3,112,100,12,0.8928571428571429
886,2023-06-06,1073,Organization 31,2030,Shelter Group 24,63,5,58,0.07936507936507936
887,2023-11-23,1099,Organization 2,2087,Shelter Group 39,116,119,-3,1.0258620689655173
888,2023-02-03,1058,Organization 45,2035,Shelter Group 7,196,139,57,0.7091836734693877
889,2023-07-20,1073,Organization 30,2087,Shelter Group 41,101,186,-85,1.8415841584158417
890,2023-10-30,1048,Organization 1,2078,Shelter Group 8,179,115,64,0.6424581005586593
891,2023-05-09,1069,Organization 8,2054,Shelter Group 18,102,126,-24,1.2352941176470589
892,2023-09-23,1040,Organization 62,2046,Shelter Group 6,90,147,-57,1.6333333333333333
893,2023-06-18,1092,Organization 43,2049,Shelter Group 26,113,171,-58,1.5132743362831858
894,2023-02-08,1062,Organization 45,2031,Shelter Group 31,69,157,-88,2.2753623188405796
895,2023-08-30,1082,Organization 84,2030,Shelter Group 1,118,131,-13,1.1101694915254237
896,2023-12-30,1006,Organization 45,2028,Shelter Group 13,117,89,28,0.7606837606837606
897,2023-08-03,1022,Organization 99,2080,Shelter Group 6,67,40,27,0.5970149253731343
898,2023-04-13,1090,Organization 65,2053,Shelter Group 10,119,73,46,0.6134453781512605
899,2023-03-21,1038,Organization 9,2022,Shelter Group 45,133,192,-59,1.443609022556391
900,2023-12-12,1036,Organization 31,2055,Shelter Group 36,182,109,73,0.5989010989010989
901,2023-01-02,1015,Organization 6,2021,Shelter Group 36,122,200,-78,1.639344262295082
902,2023-06-11,1049,Organization 70,2029,Shelter Group 28,177,137,40,0.7740112994350282
903,2023-03-19,1027,Organization 59,2032,Shelter Group 20,133,67,66,0.5037593984962406
904,2023-06-07,1072,Organization 75,2068,Shelter Group 47,145,106,39,0.7310344827586207
905,2023-06-05,1057,Organization 96,2062,Shelter Group 27,170,23,147,0.13529411764705881
906,2023-08-03,1086,Organization 4,2076,Shelter Group 24,170,6,164,0.03529411764705882
907,2023-07-05,1089,Organization 11,2067,Shelter Group 26,90,77,13,0.8555555555555555
908,2023-10-13,1014,Organization 12,2014,Shelter Group 1,134,177,-43,1.3208955223880596
909,2023-08-05,1072,Organization 89,2054,Shelter Group 5,191,193,-2,1.0104712041884816
910,2023-11-22,1003,Organization 91,2094,Shelter Group 17,180,150,30,0.8333333333333334
911,2023-07-14,1064,Organization 16,2014,Shelter Group 34,148,103,45,0.6959459459459459
912,2023-07-06,1042,Organization 21,2018,Shelter Group 6,139,137,2,0.9856115107913669
913,2023-04-25,1019,Organization 31,2052,Shelter Group 20,119,44,75,0.3697478991596639
914,2023-08-26,1031,Organization 18,2010,Shelter Group 37,144,181,-37,1.2569444444444444
915,2023-02-17,1044,Organization 34,2030,Shelter Group 17,182,167,15,0.9175824175824175
916,2023-05-18,1070,Organization 18,2089,Shelter Group 18,63,192,-129,3.0476190476190474
917,2023-01-28,1026,Organization 72,2080,Shelter Group 13,161,142,19,0.8819875776397516
918,2023-07-23,1029,Organization 29,2013,Shelter Group 29,84,86,-2,1.0238095238095237
919,2023-08-30,1039,Organization 37,2044,Shelter Group 46,196,49,147,0.25
920,2023-11-19,1021,Organization 63,2026,Shelter Group 36,158,30,128,0.189873417721519
921,2023-02-13,1057,Organization 41,2090,Shelter Group 23,200,56,144,0.28
922,2023-06-10,1004,Organization 99,2024,Shelter Group 2,74,156,-82,2.108108108108108
923,2023-06-13,1010,Organization 34,2095,Shelter Group 26,119,104,15,0.8739495798319328
924,2023-04-25,1080,Organization 63,2041,Shelter Group 43,72,55,17,0.7638888888888888
925,2023-12-01,1055,Organization 91,2032,Shelter Group 12,56,166,-110,2.9642857142857144
926,2023-03-18,1080,Organization 4,2027,Shelter Group 6,58,180,-122,3.103448275862069
927,2023-06-23,1035,Organization 94,2010,Shelter Group 1,127,126,1,0.9921259842519685
928,2023-04-04,1039,Organization 76,2090,Shelter Group 37,82,150,-68,1.829268292682927
929,2023-04-29,1030,Organization 1,2010,Shelter Group 29,101,147,-46,1.4554455445544554
930,2023-05-26,1021,Organization 97,2002,Shelter Group 46,133,102,31,0.7669172932330827
931,2023-12-30,1091,Organization 90,2070,Shelter Group 40,52,2,50,0.038461538461538464
932,2023-04-13,1038,Organization 32,2092,Shelter Group 22,99,189,-90,1.9090909090909092
933,2023-10-09,1002,Organization 12,2057,Shelter Group 49,85,1,84,0.011764705882352941
934,2023-10-19,1046,Organization 75,2066,Shelter Group 49,134,24,110,0.1791044776119403
935,2023-02-25,1036,Organization 93,2045,Shelter Group 37,135,126,9,0.9333333333333333
936,2023-11-09,1054,Organization 90,2082,Shelter Group 36,108,41,67,0.37962962962962965
937,2023-01-03,1010,Organization 12,2018,Shelter Group 40,176,118,58,0.6704545454545454
938,2023-08-05,1037,Organization 92,2075,Shelter Group 15,132,178,-46,1.3484848484848484
939,2023-01-11,1044,Organization 95,2007,Shelter Group 37,94,187,-93,1.9893617021276595
940,2023-02-20,1068,Organization 11,2014,Shelter Group 36,83,87,-4,1.0481927710843373
941,2023-09-29,1099,Organization 15,2056,Shelter Group 19,54,151,-97,2.7962962962962963
942,2023-01-11,1007,Organization 28,2050,Shelter Group 46,130,189,-59,1.4538461538461538
943,2023-08-18,1011,Organization 62,2034,Shelter Group 1,139,173,-34,1.2446043165467626
944,2023-12-18,1002,Organization 59,2048,Shelter Group 25,55,53,2,0.9636363636363636
945,2023-08-11,1013,Organization 23,2082,Shelter Group 15,155,135,20,0.8709677419354839
946,2023-04-11,1032,Organization 69,2062,Shelter Group 50,168,189,-21,1.125
947,2023-05-25,1011,Organization 27,2024,Shelter Group 16,127,97,30,0.7637795275590551
948,2023-05-13,1087,Organization 55,2073,Shelter Group 46,123,128,-5,1.0406504065040652
949,2023-04-25,1040,Organization 85,2041,Shelter Group 50,59,35,24,0.5932203389830508
950,2023-12-01,1040,Organization 20,2001,Shelter Group 17,174,35,139,0.20114942528735633
951,2023-08-31,1006,Organization 82,2064,Shelter Group 41,120,25,95,0.20833333333333334
952,2023-04-06,1005,Organization 35,2034,Shelter Group 29,116,54,62,0.46551724137931033
953,2023-11-14,1029,Organization 86,2061,Shelter Group 15,199,130,69,0.6532663316582915
954,2023-04-01,1048,Organization 27,2093,Shelter Group 27,106,65,41,0.6132075471698113
955,2023-03-30,1060,Organization 79,2090,Shelter Group 11,147,85,62,0.5782312925170068
956,2023-05-23,1065,Organization 67,2038,Shelter Group 23,144,75,69,0.5208333333333334
957,2023-05-03,1010,Organization 5,2050,Shelter Group 16,156,113,43,0.7243589743589743
958,2023-10-18,1002,Organization 18,2099,Shelter Group 11,60,100,-40,1.6666666666666667
959,2023-01-30,1099,Organization 56,2017,Shelter Group 13,76,4,72,0.05263157894736842
960,2023-06-11,1063,Organization 30,2098,Shelter Group 20,180,115,65,0.6388888888888888
961,2023-03-10,1077,Organization 74,2002,Shelter Group 19,191,118,73,0.6178010471204188
962,2023-05-10,1092,Organization 37,2038,Shelter Group 27,147,18,129,0.12244897959183673
963,2023-07-27,1015,Organization 67,2096,Shelter Group 24,190,163,27,0.8578947368421053
964,2023-01-23,1070,Organization 40,2014,Shelter Group 40,64,2,62,0.03125
965,2023-08-04,1061,Organization 75,2001,Shelter Group 14,175,177,-2,1.0114285714285713
966,2023-10-04,1015,Organization 77,2057,Shelter Group 33,79,148,-69,1.8734177215189873
967,2023-10-02,1098,Organization 83,2063,Shelter Group 33,196,47,149,0.23979591836734693
968,2023-07-30,1049,Organization 36,2061,Shelter Group 41,76,135,-59,1.7763157894736843
969,2023-07-30,1035,Organization 84,2100,Shelter Group 17,65,52,13,0.8
970,2023-07-16,1057,Organization 59,2058,Shelter Group 10,177,148,29,0.8361581920903954
971,2023-06-22,1050,Organization 95,2020,Shelter Group 24,189,166,23,0.8783068783068783
972,2023-07-27,1074,Organization 17,2077,Shelter Group 47,56,115,-59,2.0535714285714284
973,2023-12-26,1076,Organization 68,2047,Shelter Group 38,73,117,-44,1.6027397260273972
974,2023-02-01,1008,Organization 87,2043,Shelter Group 46,199,174,25,0.8743718592964824
975,2023-02-17,1008,Organization 80,2039,Shelter Group 25,173,170,3,0.9826589595375722
976,2023-09-28,1004,Organization 14,2057,Shelter Group 11,119,60,59,0.5042016806722689
977,2023-06-03,1015,Organization 11,2092,Shelter Group 40,94,196,-102,2.0851063829787235
978,2023-02-04,1081,Organization 54,2059,Shelter Group 18,74,71,3,0.9594594594594594
979,2023-02-24,1091,Organization 5,2058,Shelter Group 16,132,163,-31,1.2348484848484849
980,2023-06-01,1034,Organization 43,2022,Shelter Group 31,62,118,-56,1.903225806451613
981,2023-01-17,1027,Organization 12,2044,Shelter Group 9,61,103,-42,1.6885245901639345
982,2023-11-23,1071,Organization 70,2057,Shelter Group 6,179,108,71,0.6033519553072626
983,2023-11-29,1091,Organization 35,2036,Shelter Group 16,161,66,95,0.40993788819875776
984,2023-07-05,1013,Organization 15,2099,Shelter Group 41,125,69,56,0.552
985,2023-09-26,1008,Organization 78,2081,Shelter Group 36,152,163,-11,1.0723684210526316
986,2023-11-20,1025,Organization 17,2070,Shelter Group 44,168,82,86,0.4880952380952381
987,2023-05-07,1064,Organization 71,2034,Shelter Group 11,59,187,-128,3.169491525423729
988,2023-01-25,1053,Organization 65,2061,Shelter Group 2,56,25,31,0.44642857142857145
989,2023-01-29,1053,Organization 18,2038,Shelter Group 37,127,39,88,0.30708661417322836
990,2023-06-30,1026,Organization 67,2047,Shelter Group 29,182,146,36,0.8021978021978022
991,2023-01-16,1081,Organization 9,2078,Shelter Group 28,186,145,41,0.7795698924731183
992,2023-06-18,1012,Organization 11,2008,Shelter Group 9,138,153,-15,1.108695652173913
993,2023-08-28,1045,Organization 20,2035,Shelter Group 7,116,115,1,0.9913793103448276
994,2023-01-09,1016,Organization 49,2055,Shelter Group 28,141,170,-29,1.2056737588652482
995,2023-10-20,1010,Organization 23,2040,Shelter Group 50,66,59,7,0.8939393939393939
996,2023-11-06,1005,Organization 47,2072,Shelter Group 9,186,41,145,0.22043010752688172
997,2023-08-02,1047,Organization 100,2006,Shelter Group 13,190,14,176,0.07368421052631578
998,2023-08-26,1006,Organization 26,2026,Shelter Group 1,129,91,38,0.7054263565891473
999,2023-08-24,1021,Organization 99,2052,Shelter Group 34,125,78,47,0.624
1000,2023-01-24,1081,Organization 36,2043,Shelter Group 7,171,144,27,0.8421052631578947
